//MAP CONVERTED BY dmm2tgm.py THIS HEADER COMMENT PREVENTS RECONVERSION, DO NOT REMOVE
"a" = (
/obj/machinery/atmospherics/pipe/simple/visible/supply{
	dir = 4
	},
/obj/item/twohanded/pipewrench,
/turf/simulated/floor,
/area/serenity/shelter/upperhall)
"b" = (
/turf/simulated/wall,
/area/serenity/shelter/upperhall)
"c" = (
/obj/effect/decal/cleanable/cobweb2{
	dir = 8
	},
/obj/effect/decal/cleanable/dirt,
/turf/simulated/floor,
/area/serenity/shelter/upperhall)
"d" = (
/obj/structure/wall_frame/standard,
/obj/structure/window/basic/full,
/turf/simulated/floor,
/area/serenity/shelter/upperhall)
"e" = (
/obj/machinery/atmospherics/pipe/simple/visible/scrubbers{
	dir = 4
	},
/obj/machinery/atmospherics/pipe/simple/visible/supply{
	dir = 4
	},
/obj/structure/door_assembly,
/obj/effect/decal/cleanable/dirt,
/turf/simulated/floor/pool,
/area/serenity/shelter/upperhall)
"h" = (
/obj/effect/decal/cleanable/dirt,
/obj/random/junk,
/turf/simulated/floor/pool,
/area/serenity/shelter/upperhall)
"i" = (
/obj/item/stool,
/turf/simulated/floor/pool,
/area/serenity/shelter/upperhall)
"k" = (
/obj/effect/decal/cleanable/dirt,
/turf/simulated/floor,
/area/serenity/shelter/upperhall)
"m" = (
/obj/machinery/atmospherics/pipe/simple/visible/scrubbers{
	dir = 4
	},
/obj/machinery/floodlight{
	dir = 8
	},
/obj/effect/decal/cleanable/dirt,
/turf/simulated/floor,
/area/serenity/shelter/upperhall)
"o" = (
/turf/template_noop,
/area/template_noop)
"w" = (
/obj/machinery/atmospherics/pipe/simple/visible/scrubbers{
	dir = 4
	},
/obj/modular_map_connector,
/turf/simulated/floor/plating,
/area/serenity/shelter/upperhall)
"x" = (
/obj/effect/decal/cleanable/cobweb,
/obj/effect/decal/cleanable/dirt,
/turf/simulated/floor/pool,
/area/serenity/shelter/upperhall)
"y" = (
/turf/exterior/wall,
/area/serenity/shelter/upperhall)
"z" = (
/turf/simulated/floor/pool,
/area/serenity/shelter/upperhall)
"A" = (
/obj/item/chems/glass/paint/white,
/obj/effect/decal/cleanable/dirt,
/turf/simulated/floor/pool,
/area/serenity/shelter/upperhall)
"D" = (
/obj/effect/paint_stripe/white,
/turf/simulated/wall,
/area/serenity/shelter/upperhall)
"E" = (
/obj/structure/wall_frame/standard,
/turf/simulated/floor,
/area/serenity/shelter/upperhall)
"F" = (
/obj/machinery/atmospherics/pipe/simple/visible/scrubbers{
	dir = 4
	},
/obj/machinery/atmospherics/pipe/simple/visible/supply{
	dir = 4
	},
/obj/effect/decal/cleanable/dirt,
/turf/simulated/floor/pool,
/area/serenity/shelter/upperhall)
"S" = (
/obj/effect/decal/cleanable/dirt,
/turf/simulated/floor/pool,
/area/serenity/shelter/upperhall)
"T" = (
/obj/machinery/atmospherics/pipe/simple/visible/scrubbers{
	dir = 4
	},
/obj/machinery/atmospherics/pipe/simple/visible/supply{
	dir = 4
	},
/obj/effect/catwalk_plated,
/turf/simulated/floor,
/area/serenity/shelter/upperhall)
"Z" = (
/obj/item/chems/glass/paint/white,
/turf/simulated/floor/pool,
/area/serenity/shelter/upperhall)

(1,1,1) = {"
o
o
w
o
o
o
"}
(2,1,1) = {"
b
d
e
E
b
o
"}
(3,1,1) = {"
D
x
F
z
b
D
"}
(4,1,1) = {"
D
Z
T
z
h
b
"}
(5,1,1) = {"
b
z
a
S
c
D
"}
(6,1,1) = {"
D
h
T
i
b
D
"}
(7,1,1) = {"
b
z
T
S
A
D
"}
(8,1,1) = {"
D
k
m
z
k
b
"}
(9,1,1) = {"
b
y
y
y
D
b
"}
