//MAP CONVERTED BY dmm2tgm.py THIS HEADER COMMENT PREVENTS RECONVERSION, DO NOT REMOVE
"au" = (
/obj/effect/floor_decal/asteroid,
/turf/exterior/surface,
/area/space)
"aP" = (
/turf/simulated/wall/r_wall/glowinghull,
/area/space)
"cf" = (
/obj/machinery/modernsuit_storage,
/turf/exterior/surface,
/area/space)
"cB" = (
/obj/item/stack/material/sheet/mapped/steel/five,
/obj/effect/decal/cleanable/dirt,
/obj/structure/door_assembly/door_assembly_highsecurity,
/turf/exterior/surface,
/area/space)
"cY" = (
/obj/effect/geyser,
/turf/exterior/surface,
/area/space)
"eZ" = (
/obj/item/stack/material/sheet/mapped/steel/five,
/obj/item/radio/headset,
/turf/exterior/surface,
/area/space)
"fp" = (
/obj/effect/decal/cleanable/dirt,
/obj/item/radio/headset,
/turf/exterior/surface,
/area/space)
"fv" = (
/obj/structure/railing/mapped{
	dir = 8
	},
/turf/exterior/concrete,
/area/space)
"fN" = (
/obj/structure/firedoor_assembly,
/turf/exterior/surface,
/area/space)
"gE" = (
/obj/effect/gibspawner/robot,
/turf/exterior/surface,
/area/space)
"hA" = (
/obj/item/stack/material/ingot/mapped/stainlesssteel/five,
/obj/effect/decal/cleanable/dirt,
/obj/effect/decal/cleanable/blood/oil,
/turf/exterior/surface,
/area/space)
"iC" = (
/obj/item/stack/material/rods/two,
/obj/effect/floor_decal/asteroid,
/turf/exterior/surface,
/area/space)
"jN" = (
/obj/item/stack/material/sheet/mapped/steel/five,
/obj/effect/floor_decal/asteroid,
/turf/exterior/surface,
/area/space)
"ky" = (
/obj/effect/decal/cleanable/blood/oil,
/turf/exterior/surface,
/area/space)
"kQ" = (
/obj/effect/decal/cleanable/dirt,
/obj/effect/decal/cleanable/dirt,
/turf/exterior/surface,
/area/space)
"la" = (
/obj/structure/railing/mapped,
/obj/structure/railing/mapped{
	dir = 4
	},
/turf/simulated/open/exterior,
/area/space)
"lo" = (
/obj/effect/floor_decal/asteroid,
/obj/structure/door_assembly/door_assembly_highsecurity,
/turf/exterior/surface,
/area/space)
"ly" = (
/obj/structure/girder,
/obj/structure/firedoor_assembly,
/turf/exterior/surface,
/area/space)
"lC" = (
/obj/effect/decal/cleanable/dirt,
/obj/structure/firedoor_assembly{
	dir = 4
	},
/turf/exterior/surface,
/area/space)
"mr" = (
/obj/effect/decal/cleanable/dirt,
/obj/item/stack/ore/hematite,
/turf/exterior/surface,
/area/space)
"mN" = (
/obj/structure/door_assembly/door_assembly_hatch,
/turf/exterior/surface,
/area/space)
"oa" = (
/obj/item/stack/material/sheet/mapped/steel/five,
/obj/effect/decal/cleanable/dirt,
/turf/exterior/surface,
/area/space)
"qO" = (
/obj/item/stack/material/ingot/mapped/stainlesssteel/five,
/obj/effect/decal/cleanable/dirt,
/obj/effect/decal/cleanable/dirt,
/turf/exterior/surface,
/area/space)
"so" = (
/obj/structure/lattice,
/turf/simulated/open/exterior,
/area/space)
"sG" = (
/obj/random/ammo,
/turf/exterior/surface,
/area/space)
"to" = (
/turf/exterior/surface,
/area/space)
"tM" = (
/obj/structure/girder,
/obj/effect/decal/cleanable/dirt,
/obj/effect/decal/cleanable/dirt,
/turf/exterior/surface,
/area/space)
"tS" = (
/obj/machinery/rad_collector,
/turf/exterior/surface,
/area/space)
"uq" = (
/obj/effect/decal/cleanable/dirt,
/obj/effect/decal/cleanable/blood/gibs/robot,
/turf/exterior/surface,
/area/space)
"vj" = (
/obj/structure/grille,
/turf/exterior/surface,
/area/space)
"vz" = (
/obj/item/stack/material/rods/two,
/turf/exterior/surface,
/area/space)
"vA" = (
/turf/exterior/wall/ice,
/area/space)
"wd" = (
/obj/item/stack/material/sheet/mapped/steel/five,
/obj/effect/decal/cleanable/dirt,
/obj/effect/floor_decal/asteroid,
/turf/exterior/surface,
/area/space)
"xA" = (
/obj/effect/decal/cleanable/dirt,
/obj/effect/decal/cleanable/blood/oil,
/turf/exterior/surface,
/area/space)
"xG" = (
/obj/effect/decal/cleanable/dirt,
/obj/effect/gibspawner/human,
/turf/exterior/surface,
/area/space)
"Bh" = (
/obj/item/stack/material/sheet/mapped/steel/five,
/obj/structure/grille,
/turf/exterior/surface,
/area/space)
"Br" = (
/obj/effect/decal/cleanable/dirt,
/obj/effect/decal/cleanable/dirt,
/obj/effect/floor_decal/asteroid,
/turf/exterior/surface,
/area/space)
"Cm" = (
/obj/item/stack/material/sheet/mapped/steel/five,
/turf/exterior/surface,
/area/space)
"Dl" = (
/obj/item/stack/material/ingot/mapped/stainlesssteel/five,
/obj/effect/floor_decal/asteroid,
/turf/exterior/surface,
/area/space)
"Dw" = (
/obj/structure/railing/mapped{
	dir = 8
	},
/obj/structure/railing/mapped,
/turf/simulated/open/exterior,
/area/space)
"DQ" = (
/obj/effect/decal/cleanable/dirt,
/turf/simulated/wall/r_wall/glowinghull,
/area/space)
"Ew" = (
/obj/effect/decal/cleanable/dirt,
/obj/effect/floor_decal/asteroid,
/turf/exterior/surface,
/area/space)
"Fk" = (
/obj/structure/grille/broken,
/turf/exterior/surface,
/area/space)
"Fn" = (
/obj/effect/decal/cleanable/blood/oil,
/obj/structure/door_assembly/double{
	dir = 8
	},
/turf/exterior/surface,
/area/space)
"Fr" = (
/obj/effect/floor_decal/asteroid,
/obj/item/stack/ore/hematite,
/turf/exterior/surface,
/area/space)
"FD" = (
/obj/effect/decal/cleanable/dirt,
/obj/effect/decal/cleanable/dirt,
/obj/effect/decal/cleanable/dirt,
/turf/exterior/surface,
/area/space)
"Gg" = (
/obj/abstract/level_data/main_level,
/turf/exterior/surface,
/area/space)
"Hv" = (
/obj/item/stack/material/sheet/mapped/steel/five,
/obj/effect/decal/cleanable/dirt,
/obj/effect/decal/cleanable/dirt,
/turf/exterior/surface,
/area/space)
"HP" = (
/obj/item/stack/material/ingot/mapped/stainlesssteel/five,
/obj/effect/decal/cleanable/dirt,
/turf/exterior/surface,
/area/space)
"Im" = (
/obj/item/stack/material/rods/two,
/obj/effect/geyser,
/turf/exterior/surface,
/area/space)
"Ix" = (
/obj/item/stack/material/ingot/mapped/stainlesssteel/five,
/turf/exterior/surface,
/area/space)
"Kd" = (
/obj/effect/floor_decal/industrial/traffic/fulltile,
/turf/exterior/concrete/reinforced/road,
/area/space)
"Li" = (
/obj/structure/door_assembly/double{
	dir = 8
	},
/turf/exterior/surface,
/area/space)
"MN" = (
/obj/structure/railing/mapped{
	dir = 4
	},
/turf/exterior/concrete,
/area/space)
"NB" = (
/obj/item/stack/ore/hematite,
/turf/exterior/surface,
/area/space)
"Oa" = (
/obj/effect/decal/cleanable/dirt,
/obj/random/ammo,
/turf/exterior/surface,
/area/space)
"PB" = (
/obj/effect/decal/cleanable/dirt,
/turf/exterior/surface,
/area/space)
"PE" = (
/obj/structure/girder,
/obj/effect/decal/cleanable/dirt,
/turf/exterior/surface,
/area/space)
"PJ" = (
/turf/exterior/concrete,
/area/space)
"Qg" = (
/obj/structure/railing/mapped{
	dir = 8
	},
/turf/simulated/open/exterior,
/area/space)
"Qv" = (
/obj/structure/girder,
/obj/effect/decal/cleanable/dirt,
/obj/effect/decal/cleanable/dirt,
/obj/effect/decal/cleanable/dirt,
/turf/exterior/surface,
/area/space)
"QL" = (
/obj/item/stack/material/sheet/mapped/steel/five,
/obj/effect/decal/cleanable/blood/oil,
/turf/exterior/surface,
/area/space)
"SY" = (
/obj/item/stack/material/rods/two,
/obj/effect/decal/cleanable/dirt,
/obj/effect/decal/cleanable/dirt,
/obj/effect/decal/cleanable/dirt,
/turf/exterior/surface,
/area/space)
"Ty" = (
/obj/item/stack/material/sheet/mapped/steel/five,
/obj/item/stack/material/rods/two,
/turf/exterior/surface,
/area/space)
"TE" = (
/obj/effect/decal/cleanable/dirt,
/obj/effect/decal/cleanable/dirt,
/obj/structure/door_assembly/door_assembly_highsecurity,
/turf/exterior/surface,
/area/space)
"Un" = (
/obj/structure/railing/mapped{
	dir = 4
	},
/turf/simulated/open/exterior,
/area/space)
"Ut" = (
/obj/abstract/map_data/example{
	height = 15
	},
/turf/exterior/surface,
/area/space)
"Uv" = (
/turf/simulated/open/exterior,
/area/space)
"Wb" = (
/obj/item/stack/material/rods/two,
/obj/effect/decal/cleanable/dirt,
/turf/exterior/surface,
/area/space)
"Wj" = (
/turf/exterior/concrete/reinforced/road,
/area/space)
"WW" = (
/obj/structure/girder,
/turf/exterior/surface,
/area/space)
"XD" = (
/obj/effect/decal/cleanable/blood/gibs/robot,
/turf/exterior/surface,
/area/space)
"XI" = (
/obj/item/stack/material/rods/two,
/obj/effect/decal/cleanable/dirt,
/obj/effect/decal/cleanable/dirt,
/turf/exterior/surface,
/area/space)
"XL" = (
/obj/item/stack/material/rods/two,
/obj/effect/decal/cleanable/dirt,
/obj/effect/decal/cleanable/dirt,
/obj/effect/decal/cleanable/blood/oil,
/turf/exterior/surface,
/area/space)
"ZK" = (
/obj/effect/decal/cleanable/dirt,
/obj/effect/decal/cleanable/dirt,
/obj/item/stack/ore/hematite,
/turf/exterior/surface,
/area/space)
"ZQ" = (
/obj/effect/gibspawner/human,
/turf/exterior/surface,
/area/space)

(1,1,1) = {"
Uv
Uv
Uv
Uv
Uv
Uv
Uv
Uv
Uv
Uv
Uv
Uv
Uv
Uv
Uv
to
to
to
vA
vA
vA
vA
vA
vA
vA
vA
vA
vA
vA
vA
to
to
to
to
to
to
to
to
to
to
to
to
to
to
to
to
to
to
to
Gg
"}
(2,1,1) = {"
Uv
Uv
Uv
Uv
Uv
Uv
Uv
Uv
Uv
Uv
Uv
Uv
Uv
Uv
Uv
to
to
vA
vA
vA
vA
vA
vA
vA
vA
vA
vA
vA
vA
vA
vA
vA
vA
to
to
to
to
to
to
to
to
to
to
to
to
to
to
to
to
Ut
"}
(3,1,1) = {"
Uv
Uv
Uv
Uv
Uv
Uv
Uv
Uv
Uv
Uv
Uv
Uv
Uv
Uv
to
to
vA
vA
vA
vA
vA
vA
vA
vA
vA
vA
vA
vA
vA
vA
vA
vA
vA
vA
vA
to
to
to
to
to
to
to
to
to
to
to
to
to
to
to
"}
(4,1,1) = {"
Uv
Uv
Uv
Uv
Uv
Uv
Uv
Uv
Uv
Uv
Uv
Uv
Uv
Uv
to
to
vA
vA
vA
vA
vA
vA
vA
vA
vA
vA
vA
vA
vA
vA
vA
vA
vA
vA
vA
to
to
to
to
to
to
to
to
to
to
to
to
to
to
to
"}
(5,1,1) = {"
Uv
Uv
Uv
Uv
Uv
Uv
Uv
Uv
Uv
Uv
Uv
Uv
Uv
to
to
to
to
to
vA
vA
vA
vA
NB
to
au
to
Fr
to
NB
au
to
to
vA
vA
vA
vA
vA
to
to
to
to
to
to
to
to
to
to
to
to
to
"}
(6,1,1) = {"
Uv
Uv
Uv
Uv
Uv
Uv
Uv
Uv
Uv
Uv
Uv
Uv
to
to
to
to
to
to
vA
vA
to
to
au
NB
au
to
NB
jN
NB
NB
au
to
to
to
vA
vA
vA
to
to
to
to
to
to
to
to
to
to
to
to
to
"}
(7,1,1) = {"
Uv
Uv
Uv
Uv
Uv
Uv
Uv
Uv
Uv
Uv
Uv
Uv
to
to
to
to
to
to
to
to
to
to
aP
aP
aP
aP
to
au
to
to
to
au
to
au
au
to
vA
vA
to
to
to
to
to
to
to
to
to
to
to
to
"}
(8,1,1) = {"
Uv
Uv
Uv
Un
Un
Un
Un
Un
Un
Un
Un
MN
PJ
PJ
PJ
PJ
PJ
PJ
to
to
aP
aP
aP
to
to
XD
lC
lC
aP
aP
aP
to
to
au
to
to
to
vA
vA
PJ
PJ
PJ
PJ
PJ
to
to
to
to
to
to
"}
(9,1,1) = {"
so
so
so
Wj
Wj
Wj
Wj
Wj
Wj
Wj
Wj
Wj
Wj
Wj
Wj
Wj
Wj
to
to
aP
aP
to
to
vz
XD
HP
FD
SY
XD
to
aP
aP
aP
aP
to
to
to
Wj
Wj
Wj
Wj
Wj
Wj
PJ
to
to
to
to
to
to
"}
(10,1,1) = {"
Uv
Uv
Wj
Wj
Wj
Wj
Wj
Wj
Wj
Wj
Wj
Wj
Wj
Wj
Wj
Wj
Wj
to
aP
aP
to
to
PB
fp
Ew
kQ
oa
PB
kQ
PB
PB
to
to
aP
aP
to
to
Wj
Wj
Wj
Wj
Wj
Wj
PJ
to
to
to
to
to
to
"}
(11,1,1) = {"
Uv
Uv
so
Kd
Kd
Kd
Kd
Kd
Kd
Kd
Kd
Kd
Kd
Kd
Kd
Wj
to
to
aP
to
PB
to
PB
to
WW
XD
to
XD
PB
XD
wd
PB
cY
to
Fk
vj
to
Wj
Wj
Wj
Wj
Wj
Wj
PJ
to
to
to
to
to
to
"}
(12,1,1) = {"
Wj
Uv
so
so
Wj
Wj
Wj
Wj
Wj
Wj
Wj
Wj
Wj
Wj
Wj
Wj
to
to
aP
to
PB
Ew
Cm
Cm
to
PB
Wb
PB
uq
PB
to
PB
PE
to
to
Fk
vj
to
Wj
Wj
Wj
Wj
Wj
PJ
to
to
to
to
to
to
"}
(13,1,1) = {"
so
Uv
Uv
so
so
Wj
Wj
Wj
Wj
Wj
Wj
Wj
Wj
Wj
Wj
Wj
to
to
aP
to
to
PB
PB
PE
XD
ky
au
Cm
to
Qv
SY
PB
oa
to
to
vz
Fk
to
Wj
Wj
Wj
Wj
Wj
PJ
to
to
to
to
to
to
"}
(14,1,1) = {"
Qg
Dw
Uv
Uv
Uv
Qg
fv
fv
fv
fv
fv
fv
PJ
PJ
PJ
PJ
to
to
aP
to
to
wd
PB
to
vz
PB
uq
oa
to
to
to
kQ
kQ
PB
tM
to
Fk
to
to
Wj
Wj
Wj
Wj
PJ
to
to
to
to
to
to
"}
(15,1,1) = {"
Uv
la
Uv
Uv
Uv
Uv
to
to
to
to
to
to
to
to
to
to
to
to
aP
to
PB
to
PB
uq
to
XD
to
to
XD
to
eZ
PB
to
kQ
PB
to
vj
to
to
to
Wj
Wj
Wj
PJ
to
to
to
to
to
to
"}
(16,1,1) = {"
Uv
Uv
Uv
Uv
Uv
to
to
to
to
to
to
to
to
to
to
to
PB
to
aP
aP
to
to
to
aP
aP
aP
aP
aP
to
WW
to
PB
vz
Hv
PB
oa
Bh
to
to
to
Kd
Wj
Wj
PJ
to
to
to
to
to
to
"}
(17,1,1) = {"
Uv
Uv
Uv
Uv
to
to
to
to
vA
vA
vA
to
to
to
PB
PB
to
to
to
aP
to
to
aP
aP
to
to
to
aP
aP
to
to
to
kQ
PB
to
PB
vj
to
to
to
Kd
Wj
Wj
PJ
to
to
to
to
to
to
"}
(18,1,1) = {"
Uv
Uv
Uv
Uv
to
to
to
to
vA
to
to
to
to
to
PB
to
to
to
to
aP
to
Li
aP
to
Cm
to
to
to
aP
aP
to
Fn
kQ
to
to
kQ
to
to
to
to
Kd
Wj
Wj
PJ
to
to
to
to
to
to
"}
(19,1,1) = {"
Uv
Uv
Uv
to
to
to
to
vA
vA
to
to
to
to
PB
to
to
PB
to
PB
PB
to
to
to
PB
PB
PB
PB
PB
to
aP
to
ky
tM
oa
to
PB
to
to
to
Wj
Kd
Wj
Wj
PJ
to
to
to
to
to
to
"}
(20,1,1) = {"
Uv
Uv
to
to
to
to
to
vA
to
to
to
to
to
PB
to
PB
PB
PE
PB
PB
to
ky
to
PB
au
Wb
Ew
to
PB
PB
to
PB
FD
au
to
PB
to
to
Wj
Wj
Kd
Wj
Wj
PJ
to
to
to
to
to
to
"}
(21,1,1) = {"
Uv
to
to
to
to
to
vA
vA
to
to
to
to
to
PB
PB
to
to
to
to
PE
to
PB
ZQ
PB
to
to
PB
vz
to
to
PB
to
PB
to
to
to
to
PJ
Wj
Wj
Kd
Wj
Wj
PJ
to
to
to
to
to
to
"}
(22,1,1) = {"
Uv
to
to
to
to
to
vA
to
to
to
to
PB
to
PB
PB
to
to
to
to
PB
to
XI
PB
PB
to
PB
to
PB
to
PB
PB
to
kQ
to
to
to
to
PJ
Wj
Wj
Kd
Wj
Wj
PJ
to
to
to
to
to
to
"}
(23,1,1) = {"
to
to
to
to
to
vA
to
to
to
to
to
PB
PB
kQ
to
aP
aP
aP
to
PE
PB
to
oa
PB
WW
to
PB
kQ
PB
PE
to
kQ
PB
PB
vA
to
to
PJ
Wj
Wj
Kd
Wj
Wj
PJ
to
to
to
to
to
to
"}
(24,1,1) = {"
to
to
to
to
vA
vA
to
to
au
to
to
to
kQ
PB
aP
aP
to
aP
to
to
au
to
to
tM
kQ
PB
to
PB
tS
to
to
PB
PB
PB
vA
to
to
PJ
Wj
Wj
Kd
Wj
Wj
PJ
to
to
to
to
to
to
"}
(25,1,1) = {"
to
to
to
to
vA
to
to
to
to
to
to
PB
PB
aP
aP
to
to
aP
aP
to
to
PB
to
to
PB
to
hA
PB
to
au
PB
to
HP
kQ
vA
to
to
PJ
Wj
Wj
Kd
Wj
Wj
PJ
to
to
to
to
to
to
"}
(26,1,1) = {"
to
to
to
to
vA
to
to
to
to
to
to
kQ
aP
aP
to
to
to
to
aP
to
to
to
tS
Im
to
to
PB
Wb
PB
to
PB
tS
to
kQ
vA
vA
to
to
to
Wj
Wj
Wj
Wj
PJ
to
to
to
to
to
to
"}
(27,1,1) = {"
to
to
to
vA
vA
to
to
to
to
to
to
PB
aP
to
au
Cm
to
to
aP
aP
to
oa
PB
to
to
to
to
to
kQ
vz
PB
gE
to
PB
to
vA
to
to
to
Wj
Wj
Wj
Wj
PJ
to
to
to
to
to
to
"}
(28,1,1) = {"
to
to
to
vA
to
to
to
to
vA
to
kQ
to
aP
to
vz
to
to
to
to
aP
to
to
to
xA
PE
au
to
to
PB
PB
PB
to
PB
PB
to
vA
vA
to
to
Wj
Wj
Wj
Wj
PJ
to
to
to
to
to
to
"}
(29,1,1) = {"
to
to
to
vA
to
to
to
to
vA
to
PB
to
aP
to
to
to
WW
au
to
aP
to
to
to
to
to
PB
PB
Ew
to
PB
to
to
PB
PB
au
to
vA
to
to
to
Wj
Wj
Wj
PJ
to
to
to
to
to
to
"}
(30,1,1) = {"
to
to
to
to
to
to
to
to
vA
to
to
to
aP
to
au
Cm
to
to
to
aP
to
au
to
to
to
to
to
PB
xA
PB
to
to
PB
Cm
to
to
vA
vA
to
to
Kd
Wj
Wj
PJ
to
to
to
to
to
to
"}
(31,1,1) = {"
to
to
to
to
au
to
to
vA
vA
to
to
to
aP
to
to
to
to
to
aP
aP
aP
aP
aP
aP
aP
to
to
to
to
kQ
kQ
au
PB
to
to
to
to
vA
to
to
Kd
Wj
Wj
PJ
to
to
to
to
to
to
"}
(32,1,1) = {"
to
to
to
to
to
to
to
vA
to
to
to
to
aP
to
to
vz
to
aP
aP
to
to
to
to
to
aP
aP
to
to
Cm
PB
kQ
PB
ky
to
cY
to
to
vA
to
to
Kd
Wj
Wj
PJ
to
to
to
to
to
to
"}
(33,1,1) = {"
to
to
to
to
to
to
to
vA
to
to
to
to
aP
to
aP
aP
aP
aP
to
to
PB
PB
kQ
to
aP
aP
aP
to
to
kQ
PB
to
to
to
PB
PB
to
vA
to
to
Wj
Wj
Wj
PJ
to
to
to
to
to
to
"}
(34,1,1) = {"
to
to
to
to
to
to
to
vA
vA
to
to
to
aP
aP
aP
to
to
aP
to
Wb
xG
to
qO
PB
aP
aP
aP
aP
to
Ew
to
to
to
to
to
to
to
vA
to
to
Wj
Wj
Wj
PJ
to
to
to
to
to
to
"}
(35,1,1) = {"
to
to
to
to
to
to
to
to
vA
to
to
to
to
to
to
to
to
ly
to
ky
to
to
PB
to
aP
aP
to
aP
to
to
PB
to
PB
PB
to
to
to
vA
to
to
Wj
Wj
Wj
PJ
to
to
to
to
to
to
"}
(36,1,1) = {"
to
to
to
to
to
vA
to
to
to
to
to
to
PB
to
PB
PB
to
aP
kQ
to
PB
PE
Wb
PB
aP
aP
to
aP
aP
to
to
PB
PB
PB
PB
to
vA
vA
to
to
Wj
Wj
Wj
PJ
to
to
to
to
to
to
"}
(37,1,1) = {"
to
to
to
to
to
vA
to
to
to
to
to
PB
PB
PB
to
PB
to
aP
Ty
PB
kQ
to
to
to
aP
aP
to
to
aP
to
to
PB
PB
au
to
to
vA
to
to
to
Kd
Wj
Wj
PJ
to
to
to
to
to
to
"}
(38,1,1) = {"
to
to
to
to
to
vA
vA
to
to
au
to
PB
to
to
PB
to
to
aP
to
PB
to
to
to
to
aP
aP
to
to
to
aP
to
to
to
to
to
to
vA
to
to
Wj
Kd
Wj
Wj
PJ
to
to
to
to
to
to
"}
(39,1,1) = {"
to
to
to
to
to
to
vA
to
to
to
to
au
to
to
to
to
to
aP
to
PB
PE
Cm
PB
PB
aP
aP
to
to
to
aP
aP
to
vz
to
to
to
vA
to
to
Wj
Kd
Wj
Wj
PJ
to
to
to
to
to
to
"}
(40,1,1) = {"
to
to
to
au
to
to
vA
to
to
to
to
to
to
to
to
PB
to
aP
to
to
to
PB
xA
PB
aP
aP
to
au
to
aP
aP
to
to
to
to
vA
vA
to
to
Wj
Wj
Wj
Wj
PJ
to
to
to
to
to
to
"}
(41,1,1) = {"
to
to
to
to
to
to
vA
vA
to
to
to
to
to
to
PB
PB
to
mN
to
to
to
vz
PB
to
aP
aP
to
to
to
to
to
to
Ix
to
to
vA
to
to
Wj
Wj
Wj
Wj
Wj
PJ
to
to
to
to
to
to
"}
(42,1,1) = {"
to
to
to
to
to
to
to
vA
to
to
to
to
to
to
to
to
to
aP
to
WW
cf
to
cf
to
aP
aP
to
PB
PB
PB
PB
PB
to
to
vA
to
to
PJ
Wj
Wj
Wj
Wj
Wj
PJ
to
to
to
to
to
to
"}
(43,1,1) = {"
to
to
to
to
to
to
to
vA
vA
to
to
to
kQ
PB
to
Wb
to
aP
to
to
aP
aP
aP
to
aP
to
to
PE
to
PB
PB
kQ
PB
to
vA
to
to
PJ
Wj
Wj
Wj
Wj
Wj
PJ
to
to
to
to
to
to
"}
(44,1,1) = {"
to
to
to
to
to
to
to
to
vA
to
to
to
to
to
to
to
to
aP
aP
aP
aP
to
aP
aP
aP
to
PB
to
PB
PB
xA
PB
to
to
to
to
to
PJ
Wj
Wj
Kd
Wj
Wj
PJ
to
to
to
to
to
to
"}
(45,1,1) = {"
to
to
to
to
to
to
to
to
vA
vA
to
to
to
to
to
to
to
to
aP
to
to
to
to
to
to
to
PB
to
PB
to
PB
au
to
to
to
to
to
PJ
Wj
Wj
Kd
Wj
Wj
PJ
to
to
to
to
to
to
"}
(46,1,1) = {"
to
to
to
to
to
to
to
to
to
vA
to
to
to
to
to
PB
PB
to
aP
to
to
PB
kQ
PB
PB
to
HP
PB
to
xG
vz
to
to
to
to
to
to
PJ
Wj
Wj
Kd
Wj
Wj
PJ
to
to
to
to
to
to
"}
(47,1,1) = {"
to
to
to
to
to
to
to
to
to
to
to
to
to
to
to
to
PB
to
aP
to
aP
aP
PB
WW
au
to
cY
PB
PE
PB
to
to
to
to
to
to
to
PJ
Wj
Wj
Wj
Wj
Wj
PJ
to
to
to
to
to
to
"}
(48,1,1) = {"
to
to
to
to
to
to
au
to
to
to
to
to
to
au
to
PB
PB
WW
to
to
PB
aP
PB
WW
to
to
PB
PB
PB
to
to
vA
vA
to
to
to
to
PJ
Wj
Wj
Wj
Wj
Wj
PJ
to
to
to
to
to
to
"}
(49,1,1) = {"
vA
vA
to
to
to
to
to
to
to
to
to
to
to
to
to
to
to
WW
to
PB
kQ
au
kQ
aP
aP
aP
to
to
au
PB
to
to
to
vA
vA
vA
to
to
Wj
Wj
Wj
Wj
Wj
PJ
to
to
to
to
to
to
"}
(50,1,1) = {"
vA
vA
vA
vA
to
to
to
to
to
to
to
to
to
to
vz
to
aP
to
to
Wb
PB
ky
to
aP
aP
aP
to
to
to
PB
PB
to
to
to
vz
vA
to
to
Wj
Wj
Wj
Wj
Wj
PJ
to
to
to
to
to
to
"}
(51,1,1) = {"
vA
vA
vA
vA
vA
to
to
to
to
to
to
to
PB
to
to
aP
aP
vz
to
qO
ZQ
to
to
aP
aP
aP
aP
to
to
to
PB
to
to
to
to
to
vA
to
Wj
Wj
Kd
Wj
Wj
PJ
to
to
to
to
to
to
"}
(52,1,1) = {"
vA
vA
vA
vA
vA
vA
to
to
to
to
to
to
PB
to
to
aP
aP
to
Ew
FD
aP
aP
aP
aP
aP
aP
aP
aP
to
to
PB
to
to
to
to
to
vA
to
to
Wj
Kd
Wj
Wj
PJ
to
to
to
to
to
to
"}
(53,1,1) = {"
vA
vA
vA
vA
vA
vA
to
to
to
to
to
to
to
to
to
aP
aP
PB
XL
PB
aP
to
to
au
to
aP
aP
aP
aP
to
PB
to
WW
to
to
to
vA
to
to
Wj
Kd
Wj
Wj
PJ
to
to
to
to
to
to
"}
(54,1,1) = {"
vA
vA
vA
vA
vA
vA
vA
PB
to
to
to
to
to
to
to
aP
aP
PB
PB
to
aP
PB
QL
to
vz
to
aP
aP
aP
to
xA
to
to
to
to
to
to
to
to
Wj
Wj
Wj
Wj
PJ
to
to
to
to
to
to
"}
(55,1,1) = {"
vA
vA
vA
vA
vA
vA
vA
PB
to
PB
to
to
to
PB
to
aP
DQ
PB
Br
to
aP
PB
Wb
Oa
PB
to
aP
aP
aP
to
to
Wb
to
to
au
to
to
to
to
Wj
Wj
Wj
Wj
PJ
to
to
to
to
to
to
"}
(56,1,1) = {"
vA
vA
vA
vA
vA
vA
to
PB
to
PB
to
to
au
PB
to
aP
aP
to
to
to
WW
to
Ew
kQ
to
PB
PB
aP
aP
to
au
PB
to
to
to
to
to
to
to
to
Wj
Wj
Wj
PJ
to
to
to
to
to
to
"}
(57,1,1) = {"
vA
vA
vA
vA
vA
to
NB
au
au
PB
to
to
to
PB
to
aP
aP
aP
aP
aP
aP
to
Cm
PB
Cm
sG
PB
aP
aP
to
to
PB
to
PB
to
to
to
to
to
to
Wj
Wj
Wj
PJ
to
to
to
to
to
to
"}
(58,1,1) = {"
vA
vA
vA
vA
vA
to
au
Ew
mr
PB
to
to
to
to
to
to
aP
aP
to
to
sG
to
PB
Ew
Wb
to
to
cB
to
to
PB
to
to
PB
ky
to
to
to
to
to
Kd
Wj
Wj
PJ
to
to
to
to
to
to
"}
(59,1,1) = {"
vA
vA
vA
vA
to
PB
Ew
au
to
to
to
to
to
to
to
to
aP
aP
aP
aP
to
to
to
to
HP
PB
au
to
PB
PB
PB
to
to
PB
to
au
to
to
to
Wj
Kd
Wj
Wj
PJ
to
to
to
to
to
to
"}
(60,1,1) = {"
vA
vA
vA
vA
to
PB
kQ
PB
PB
PB
to
to
to
to
to
to
to
aP
aP
aP
aP
to
vz
to
to
DQ
DQ
xG
to
to
kQ
PB
Wb
to
to
to
to
to
Wj
Wj
Kd
Wj
Wj
PJ
to
to
to
to
to
to
"}
(61,1,1) = {"
vA
vA
vA
vA
to
Ew
kQ
PB
PB
Ew
to
to
to
PB
aP
to
PB
to
aP
aP
aP
aP
to
to
cY
aP
to
PB
to
to
aP
to
vz
to
to
to
to
PJ
Wj
Wj
Wj
Wj
Wj
PJ
to
to
to
to
to
to
"}
(62,1,1) = {"
vA
vA
vA
vA
to
Ew
ZK
PB
PB
PB
to
to
to
to
aP
to
PB
PB
to
to
aP
aP
aP
aP
lo
aP
xA
PB
to
to
aP
Dl
to
to
to
to
to
PJ
Wj
Wj
Wj
Wj
Wj
PJ
to
to
to
to
to
to
"}
(63,1,1) = {"
vA
vA
vA
vA
to
to
PB
mr
PB
PB
to
to
vz
to
aP
to
to
PB
to
to
PB
DQ
aP
aP
to
Cm
to
PB
WW
aP
aP
to
PB
to
to
to
to
PJ
Wj
Wj
Wj
Wj
Wj
PJ
to
to
to
to
to
to
"}
(64,1,1) = {"
vA
vA
vA
vA
vA
to
Ew
kQ
kQ
Ew
to
to
fN
aP
aP
to
WW
ky
Ew
to
to
PB
to
to
to
to
to
PB
aP
aP
to
PB
PB
to
to
to
to
PJ
Wj
Wj
Wj
Wj
Wj
PJ
to
to
to
to
to
to
"}
(65,1,1) = {"
vA
vA
vA
vA
vA
vA
au
to
to
to
to
to
to
aP
to
to
to
to
vz
to
to
Wb
to
to
aP
to
au
PB
PB
PB
PB
PB
to
to
to
to
to
PJ
Wj
Wj
Kd
Wj
Wj
PJ
to
to
to
to
to
to
"}
(66,1,1) = {"
vA
vA
vA
vA
vA
vA
to
to
to
to
to
to
to
aP
to
PB
PB
to
Ix
PB
PB
to
PB
to
aP
to
to
PB
aP
aP
to
to
au
to
to
to
to
PJ
Wj
Wj
Kd
Wj
Wj
PJ
to
to
to
to
to
to
"}
(67,1,1) = {"
vA
vA
vA
vA
vA
vA
vA
to
to
au
to
aP
aP
aP
to
PB
to
to
to
tM
PB
to
Ew
to
aP
to
to
PB
to
aP
to
PB
PB
to
to
to
to
PJ
Wj
Wj
Kd
Wj
Wj
PJ
to
to
to
to
to
to
"}
(68,1,1) = {"
vA
vA
vA
vA
vA
vA
to
to
to
to
to
aP
to
to
PB
au
WW
to
PB
to
NB
to
to
to
aP
aP
to
PB
to
aP
au
to
PB
to
to
to
to
PJ
Wj
Wj
Wj
Wj
Wj
PJ
to
to
to
to
to
to
"}
(69,1,1) = {"
vA
vA
vA
vA
to
to
to
to
to
to
to
aP
to
PB
PB
to
to
Wb
to
to
to
PB
PB
vz
aP
aP
aP
to
to
to
to
to
PB
to
WW
to
to
PJ
Wj
Wj
Wj
Wj
Wj
PJ
to
to
to
to
to
to
"}
(70,1,1) = {"
vA
vA
vA
vA
to
to
vz
to
to
to
to
aP
to
PB
to
to
to
PB
to
au
to
to
PB
PB
to
to
aP
aP
PB
PB
PB
to
PB
to
to
to
to
PJ
Wj
Wj
Wj
Wj
Wj
PJ
to
to
to
to
to
to
"}
(71,1,1) = {"
vA
vA
vA
vA
to
to
to
to
to
to
PB
aP
to
to
PB
to
PB
PB
to
PB
PB
WW
ky
PB
to
to
PB
aP
to
PB
PB
to
PB
to
to
to
to
PJ
Wj
Wj
Wj
Wj
Wj
PJ
to
to
to
to
to
to
"}
(72,1,1) = {"
vA
vA
vA
vA
to
to
to
to
to
to
PB
DQ
to
to
Wb
to
kQ
to
to
kQ
to
to
to
au
to
to
to
aP
to
PB
to
to
PB
to
to
to
to
PJ
Wj
Wj
Kd
Wj
Wj
PJ
to
to
to
to
to
to
"}
(73,1,1) = {"
vA
vA
vA
to
to
to
to
to
to
to
to
PB
WW
to
ky
kQ
PB
to
to
Ew
aP
to
to
to
vz
to
cY
aP
to
PB
to
to
PB
to
jN
to
to
PJ
Wj
Wj
Kd
Wj
Wj
PJ
to
to
to
to
to
to
"}
(74,1,1) = {"
vA
vA
vA
to
to
to
to
to
to
to
to
to
to
to
PB
PB
au
PB
PB
vz
aP
aP
PB
PB
to
to
au
aP
PB
au
to
xG
PE
to
to
to
to
PJ
Wj
Wj
Kd
Wj
Wj
PJ
to
to
to
to
to
to
"}
(75,1,1) = {"
vA
vA
to
to
to
to
to
to
PB
to
PB
au
to
PB
to
HP
PB
TE
PB
PB
aP
to
PB
FD
WW
kQ
to
aP
oa
PB
PB
to
to
to
to
to
to
PJ
Wj
Wj
Wj
Wj
Wj
PJ
to
to
to
to
to
to
"}
(76,1,1) = {"
vA
vA
to
to
to
to
to
to
PB
to
PB
to
to
FD
XI
PB
to
ZQ
vz
PB
aP
PB
PB
XI
to
PB
to
aP
to
PB
to
to
to
to
to
to
to
PJ
Wj
Wj
Wj
Wj
Wj
PJ
to
to
to
to
to
to
"}
(77,1,1) = {"
vA
vA
to
to
to
to
to
to
PB
to
PB
PB
PB
to
to
to
to
PB
xA
PB
aP
PB
to
PB
to
Ix
xA
aP
PB
PB
to
to
au
to
to
to
to
PJ
Wj
Wj
Wj
Wj
Wj
PJ
to
to
to
to
to
to
"}
(78,1,1) = {"
vA
to
to
to
to
to
to
to
PB
vz
PB
PB
to
to
au
to
to
PB
PB
to
aP
to
to
FD
au
to
PB
to
PB
to
to
to
to
to
to
to
to
PJ
Wj
Wj
Wj
Wj
Wj
PJ
to
to
to
to
to
to
"}
(79,1,1) = {"
vA
to
to
to
to
Cm
to
to
PB
to
to
kQ
PB
DQ
to
to
to
WW
Ew
PB
aP
iC
kQ
FD
PB
PB
vz
to
to
PB
to
to
to
to
to
to
to
PJ
Wj
Wj
Kd
Wj
Wj
PJ
to
to
to
to
to
to
"}
(80,1,1) = {"
vA
to
to
to
to
to
to
to
to
PB
PB
to
to
aP
to
to
vz
to
to
PB
aP
to
PB
PB
to
to
to
kQ
PB
to
to
to
to
to
to
to
to
PJ
Wj
Wj
Kd
Wj
Wj
PJ
to
to
to
to
to
to
"}
(81,1,1) = {"
vA
to
to
to
to
to
to
to
to
to
PB
to
aP
aP
aP
aP
to
to
to
to
aP
PB
FD
to
WW
to
to
PB
to
au
to
to
to
to
to
to
to
PJ
Wj
Wj
Kd
Wj
Wj
PJ
to
to
to
to
to
to
"}
(82,1,1) = {"
to
to
to
to
to
to
to
to
to
to
PB
to
to
aP
to
aP
aP
to
PB
to
kQ
PB
kQ
PB
to
to
to
PB
to
to
to
to
to
to
to
to
to
PJ
Wj
Wj
Wj
Wj
Wj
PJ
to
to
to
to
to
to
"}
(83,1,1) = {"
to
to
to
to
to
to
to
to
to
to
kQ
to
to
aP
to
to
aP
PB
to
to
PB
to
to
PB
kQ
to
Br
to
to
to
to
to
to
to
au
to
to
PJ
Wj
Wj
Wj
Wj
Wj
PJ
to
to
to
to
to
to
"}
(84,1,1) = {"
to
to
to
to
to
to
to
to
to
to
oa
PB
PB
aP
to
to
to
PB
to
PB
cY
to
to
to
FD
kQ
PB
to
to
to
to
to
to
to
to
to
to
PJ
Wj
Wj
Wj
Wj
Wj
PJ
to
to
to
to
to
to
"}
(85,1,1) = {"
to
to
to
to
to
to
vz
to
to
PB
kQ
to
PB
aP
to
au
to
PB
PB
to
to
xA
to
Ew
PB
PB
to
to
PB
to
to
to
to
to
to
to
to
PJ
Wj
Wj
Wj
Wj
Wj
PJ
to
to
to
to
to
to
"}
(86,1,1) = {"
to
to
to
to
to
to
to
to
to
to
PB
to
PB
aP
to
to
PB
kQ
to
vA
to
PB
ZQ
PB
PB
PB
to
to
to
to
to
to
to
to
to
to
to
PJ
Wj
Wj
Kd
Wj
Wj
PJ
to
to
to
to
to
to
"}
(87,1,1) = {"
to
to
to
to
to
to
to
to
to
PB
PB
to
kQ
to
to
to
PB
xA
to
vA
to
PB
vA
PB
PB
PB
Ew
to
to
PB
to
to
Cm
to
to
to
to
PJ
Wj
Wj
Kd
Wj
Wj
PJ
to
to
to
to
to
to
"}
(88,1,1) = {"
to
to
to
to
to
to
to
to
to
PB
PB
to
PB
to
vA
vA
kQ
au
to
vA
to
PB
vA
to
PB
to
PB
to
to
PB
PB
to
to
to
to
to
to
PJ
Wj
Wj
Kd
Wj
Wj
PJ
to
to
to
to
to
to
"}
(89,1,1) = {"
to
to
to
to
to
to
to
PB
PB
to
PB
to
PB
to
vA
to
kQ
to
to
vA
au
PB
vA
to
to
vA
vA
to
to
to
Ew
to
to
to
to
to
to
PJ
Wj
Wj
Wj
Wj
Wj
PJ
to
to
to
to
to
to
"}
(90,1,1) = {"
to
to
to
to
Cm
to
to
PB
PB
to
PB
to
PB
to
vA
to
kQ
Ix
vA
vA
to
PB
vA
to
ky
to
vA
to
to
to
PB
to
to
to
to
to
to
PJ
Wj
Wj
Wj
Wj
Wj
PJ
to
to
to
to
to
to
"}
(91,1,1) = {"
to
to
to
to
to
to
to
kQ
PB
to
to
to
PB
to
vA
to
kQ
to
vA
to
to
PB
vA
to
to
to
to
vA
to
to
PB
to
to
to
to
to
to
PJ
Wj
Wj
Wj
Wj
Wj
PJ
to
to
to
to
to
to
"}
(92,1,1) = {"
to
to
to
to
to
to
to
PB
PB
PB
to
to
PB
to
vA
to
PB
to
vA
to
to
to
vA
to
to
to
to
vA
vA
to
to
to
to
to
to
to
to
PJ
Wj
Wj
Wj
Wj
Wj
PJ
to
to
to
to
to
to
"}
(93,1,1) = {"
to
to
to
to
to
to
to
PB
PB
PB
PB
PB
to
to
vA
to
kQ
to
vA
to
PB
to
vA
to
PB
to
to
to
vA
to
PB
to
to
to
to
to
to
PJ
Wj
Wj
Kd
Wj
Wj
PJ
to
to
to
to
to
to
"}
(94,1,1) = {"
Uv
to
to
to
to
to
to
to
to
to
to
to
to
vA
vA
PB
ky
to
vA
to
PB
to
vA
to
PB
to
to
to
vA
to
PB
to
to
to
to
to
to
PJ
Wj
Wj
Kd
Wj
Wj
PJ
to
to
to
to
to
to
"}
(95,1,1) = {"
Uv
to
to
to
to
to
to
to
to
to
to
to
to
vA
to
to
PB
to
to
PB
to
to
to
to
to
to
to
to
vA
to
PB
to
to
to
to
to
to
PJ
Wj
Wj
Kd
Wj
Wj
PJ
to
to
to
to
to
to
"}
(96,1,1) = {"
Uv
to
to
to
to
to
to
to
to
to
to
to
vA
vA
to
PB
PB
to
to
to
ky
to
to
PB
PB
PB
to
to
vA
to
PB
to
to
to
to
to
to
PJ
Wj
Wj
Wj
Wj
Wj
PJ
to
to
to
to
to
to
"}
(97,1,1) = {"
to
to
to
to
to
to
to
to
to
vA
to
to
to
to
to
to
to
to
to
to
to
to
to
to
PB
to
to
to
to
to
to
to
to
to
to
to
to
PJ
Wj
Wj
Wj
Wj
Wj
PJ
to
to
to
to
to
to
"}
(98,1,1) = {"
to
to
to
to
to
to
to
to
to
vA
to
to
to
to
to
to
to
to
to
to
to
to
to
to
to
to
to
to
to
to
to
vA
to
to
to
to
to
PJ
Wj
Wj
Wj
Wj
Wj
PJ
to
to
to
to
to
to
"}
(99,1,1) = {"
to
to
to
to
to
to
to
to
to
vA
to
to
to
to
to
to
to
to
Wj
Wj
Wj
Wj
Wj
Wj
Wj
Wj
Wj
Wj
Wj
to
to
vA
to
to
to
to
to
PJ
Wj
Wj
Wj
Wj
Wj
PJ
to
to
to
to
to
to
"}
(100,1,1) = {"
to
to
to
to
to
to
to
to
to
vA
to
to
to
to
to
to
to
to
Wj
Wj
Wj
Wj
Wj
Wj
Wj
Wj
Wj
Wj
Wj
to
to
vA
to
to
to
to
to
PJ
Wj
Wj
Kd
Wj
Wj
PJ
to
to
to
to
to
to
"}
(101,1,1) = {"
to
to
to
to
to
to
to
to
to
vA
to
to
to
to
to
to
to
to
Wj
Wj
Wj
Wj
Wj
Wj
Wj
Wj
Wj
Wj
Wj
to
to
vA
to
to
to
to
to
PJ
Wj
Wj
Kd
Wj
Wj
PJ
to
to
to
to
to
to
"}
(102,1,1) = {"
to
to
to
to
to
to
to
to
to
vA
to
to
to
to
to
to
to
to
Wj
Wj
Wj
Wj
Wj
Wj
Wj
Wj
Wj
Wj
Wj
to
to
vA
to
to
to
to
to
PJ
Wj
Wj
Kd
Wj
Wj
PJ
to
to
to
to
to
to
"}
(103,1,1) = {"
to
to
to
to
to
to
to
to
vA
vA
to
to
to
to
to
to
to
to
Wj
Wj
Wj
Wj
Wj
Wj
Wj
Wj
Wj
Wj
Wj
to
to
vA
to
to
to
to
to
PJ
Wj
Wj
Wj
Wj
Wj
PJ
to
to
to
to
to
to
"}
(104,1,1) = {"
to
to
to
to
to
to
to
to
vA
to
to
to
to
to
to
to
to
to
Wj
Wj
Wj
Wj
Wj
Wj
Wj
Wj
Wj
Wj
Wj
to
to
vA
vA
to
to
to
to
PJ
Wj
Wj
Wj
Wj
Wj
PJ
to
to
to
to
to
to
"}
(105,1,1) = {"
to
to
to
to
to
to
to
vA
vA
to
to
to
to
to
to
to
to
to
Wj
Wj
Wj
Wj
Wj
Wj
Wj
Wj
Wj
Wj
Wj
to
to
to
vA
to
to
to
to
PJ
Wj
Wj
Wj
Wj
Wj
PJ
to
to
to
to
to
to
"}
(106,1,1) = {"
to
to
to
to
to
to
to
vA
to
to
to
to
to
to
to
to
to
to
Wj
Wj
Wj
Wj
Wj
Wj
Wj
Wj
Wj
Wj
Wj
to
to
to
vA
to
to
to
to
PJ
Wj
Wj
Wj
Wj
Wj
PJ
to
to
to
to
to
to
"}
(107,1,1) = {"
to
to
to
to
to
to
vA
vA
to
to
to
to
to
to
to
to
to
to
Wj
Wj
Wj
Wj
Wj
Wj
Wj
Wj
Wj
Wj
Wj
to
to
to
to
vA
to
to
to
PJ
Wj
Wj
Kd
Wj
Wj
PJ
to
to
to
to
to
to
"}
(108,1,1) = {"
to
to
to
to
to
vA
vA
to
to
to
to
to
to
to
to
to
to
to
Wj
Wj
Wj
Wj
Wj
Wj
Wj
Wj
Wj
Wj
Wj
to
to
to
to
vA
to
to
to
PJ
Wj
Wj
Kd
Wj
Wj
PJ
to
to
to
to
to
to
"}
(109,1,1) = {"
to
to
to
to
to
vA
to
to
to
to
to
to
to
to
to
to
to
to
Wj
Wj
Wj
Wj
Wj
Wj
Wj
Wj
Wj
Wj
Wj
to
to
to
to
vA
vA
to
to
PJ
Wj
Wj
Kd
Wj
Wj
PJ
to
to
to
to
to
to
"}
(110,1,1) = {"
to
to
to
to
to
to
to
to
to
to
to
to
to
to
to
to
to
to
Wj
Wj
Wj
Wj
Wj
Wj
Wj
Wj
Wj
Wj
Wj
to
to
to
to
to
vA
to
to
PJ
Wj
Wj
Wj
Wj
Wj
PJ
to
to
to
to
to
to
"}
(111,1,1) = {"
to
to
to
to
to
to
to
to
to
to
to
to
to
to
to
to
to
to
Wj
Wj
Wj
Wj
Wj
Wj
Wj
Wj
Wj
Wj
Wj
to
to
to
to
to
to
vA
to
PJ
Wj
Wj
Wj
Wj
Wj
PJ
to
to
to
to
to
to
"}
(112,1,1) = {"
to
to
to
to
to
to
to
to
to
to
to
to
to
to
to
to
to
to
Wj
Wj
Wj
Wj
Wj
Wj
Wj
Wj
Wj
Wj
Wj
to
to
to
to
to
to
to
to
PJ
Wj
Wj
Wj
Wj
Wj
PJ
to
to
to
to
to
to
"}
(113,1,1) = {"
to
to
to
to
to
to
to
to
to
to
to
to
to
to
to
to
to
to
to
to
to
to
Wj
Wj
Wj
to
to
to
to
to
to
to
to
to
to
to
to
PJ
Wj
Wj
Wj
Wj
Wj
PJ
to
to
to
to
to
to
"}
(114,1,1) = {"
to
to
to
to
to
to
to
to
to
to
to
to
to
to
to
to
to
to
to
to
to
to
Wj
Wj
Wj
to
to
to
to
to
to
to
to
to
to
to
to
PJ
Wj
Wj
Kd
Wj
Wj
PJ
to
to
to
to
to
to
"}
(115,1,1) = {"
to
to
to
to
to
to
to
to
to
to
to
to
to
to
to
to
to
to
to
to
to
to
Wj
Wj
Wj
to
to
to
to
to
to
to
to
to
to
to
to
PJ
Wj
Wj
Kd
Wj
Wj
PJ
to
to
to
to
to
to
"}
(116,1,1) = {"
to
to
to
to
to
to
to
to
to
to
to
to
to
to
to
to
to
to
to
to
to
to
Wj
Wj
Wj
to
to
to
to
to
to
to
to
to
to
to
to
PJ
Wj
Wj
Kd
Wj
Wj
PJ
to
to
to
to
to
to
"}
(117,1,1) = {"
to
to
to
to
to
to
to
to
to
to
to
to
to
to
to
to
to
to
to
to
to
to
Wj
Wj
Wj
to
to
to
to
to
to
to
to
to
to
to
PJ
PJ
Wj
Wj
Kd
Wj
Wj
PJ
PJ
to
to
to
to
to
"}
(118,1,1) = {"
PJ
PJ
PJ
PJ
PJ
PJ
PJ
PJ
PJ
PJ
PJ
PJ
PJ
PJ
PJ
PJ
PJ
PJ
PJ
PJ
PJ
PJ
Wj
Wj
Wj
PJ
PJ
PJ
PJ
PJ
PJ
PJ
PJ
PJ
PJ
PJ
PJ
Wj
Wj
Wj
Kd
Wj
Wj
Wj
PJ
PJ
PJ
PJ
PJ
PJ
"}
(119,1,1) = {"
Wj
Wj
Wj
Wj
Wj
Wj
Wj
Wj
Wj
Wj
Wj
Wj
Wj
Wj
Wj
Wj
Wj
Wj
Wj
Wj
Wj
Wj
Wj
Wj
Wj
Wj
Wj
Wj
Wj
Wj
Wj
Wj
Wj
Wj
Wj
Wj
Wj
Wj
Wj
Wj
Kd
Wj
Wj
Wj
Wj
Wj
Wj
Wj
Wj
Wj
"}
(120,1,1) = {"
Wj
Wj
Wj
Wj
Wj
Wj
Wj
Wj
Wj
Wj
Wj
Wj
Wj
Wj
Wj
Wj
Wj
Wj
Wj
Wj
Wj
Wj
Wj
Wj
Wj
Wj
Wj
Wj
Wj
Wj
Wj
Wj
Wj
Wj
Wj
Wj
Wj
Wj
Wj
Wj
Kd
Wj
Wj
Wj
Wj
Wj
Wj
Wj
Wj
Wj
"}
(121,1,1) = {"
Wj
Wj
Wj
Wj
Kd
Kd
Kd
Wj
Wj
Wj
Wj
Kd
Kd
Kd
Wj
Wj
Wj
Wj
Kd
Kd
Kd
Kd
Kd
Kd
Kd
Kd
Kd
Kd
Kd
Kd
Kd
Kd
Kd
Kd
Kd
Kd
Kd
Kd
Kd
Kd
Kd
Kd
Kd
Kd
Kd
Kd
Kd
Kd
Kd
Kd
"}
(122,1,1) = {"
Wj
Wj
Wj
Wj
Wj
Wj
Wj
Wj
Wj
Wj
Wj
Wj
Wj
Wj
Wj
Wj
Wj
Wj
Wj
Wj
Wj
Wj
Wj
Wj
Wj
Wj
Wj
Wj
Wj
Wj
Wj
Wj
Wj
Wj
Wj
Wj
Wj
Wj
Wj
Wj
Wj
Wj
Wj
Wj
Wj
Wj
Wj
Wj
Wj
Wj
"}
(123,1,1) = {"
Wj
Wj
Wj
Wj
Wj
Wj
Wj
Wj
Wj
Wj
Wj
Wj
Wj
Wj
Wj
Wj
Wj
Wj
Wj
Wj
Wj
Wj
Wj
Wj
Wj
Wj
Wj
Wj
Wj
Wj
Wj
Wj
Wj
Wj
Wj
Wj
Wj
Wj
Wj
Wj
Wj
Wj
Wj
Wj
Wj
Wj
Wj
Wj
Wj
Wj
"}
(124,1,1) = {"
PJ
PJ
PJ
PJ
PJ
PJ
PJ
PJ
PJ
PJ
PJ
PJ
PJ
PJ
PJ
PJ
PJ
PJ
PJ
PJ
PJ
PJ
PJ
PJ
PJ
PJ
PJ
PJ
PJ
PJ
PJ
PJ
PJ
PJ
PJ
PJ
PJ
PJ
PJ
PJ
PJ
PJ
PJ
PJ
PJ
PJ
PJ
PJ
PJ
PJ
"}
(125,1,1) = {"
to
to
to
to
to
to
to
to
to
to
to
to
to
to
to
to
to
to
to
to
to
to
to
to
to
to
to
to
to
to
to
to
to
to
to
to
to
to
to
to
to
to
to
to
to
to
to
to
to
to
"}
(126,1,1) = {"
to
to
to
to
to
to
to
to
to
to
to
to
to
to
to
to
to
to
to
to
to
to
to
to
to
to
to
to
to
to
to
to
to
to
to
to
to
to
to
to
to
to
to
to
to
to
to
to
to
to
"}
(127,1,1) = {"
to
to
to
to
to
to
to
to
to
to
to
to
to
to
to
to
to
to
to
to
to
to
to
to
to
to
to
to
to
to
to
to
to
to
to
to
to
to
to
to
to
to
to
to
to
to
to
to
to
to
"}
(128,1,1) = {"
to
to
to
to
to
to
to
to
to
to
to
to
to
to
to
to
to
to
to
to
to
to
to
to
to
to
to
to
to
to
to
to
to
to
to
to
to
to
to
to
to
to
to
to
to
to
to
to
to
to
"}
