//MAP CONVERTED BY dmm2tgm.py THIS HEADER COMMENT PREVENTS RECONVERSION, DO NOT REMOVE
"a" = (
/turf/exterior/surface,
/area/surface)
"b" = (
/obj/structure/railing,
/obj/structure/railing/mapped{
	dir = 4
	},
/turf/simulated/open/exterior,
/area/surface)
"c" = (
/obj/effect/decal/cleanable/dirt,
/obj/effect/decal/cleanable/dirt,
/obj/effect/decal/cleanable/dirt,
/turf/exterior/concrete/reinforced/road,
/area/surface)
"d" = (
/turf/exterior/concrete/reinforced/road,
/area/surface)
"e" = (
/obj/effect/decal/cleanable/ash,
/obj/effect/decal/cleanable/dirt,
/obj/effect/decal/cleanable/dirt,
/turf/exterior/concrete/reinforced/road,
/area/surface)
"f" = (
/turf/simulated/open/exterior,
/area/surface)
"g" = (
/obj/effect/decal/cleanable/dirt,
/obj/effect/decal/cleanable/dirt,
/turf/exterior/concrete/reinforced/road,
/area/surface)
"h" = (
/obj/structure/girder,
/turf/exterior/surface,
/area/surface)
"j" = (
/obj/effect/floor_decal/industrial/traffic/fulltile,
/obj/effect/overmap_edge{
	dir = 8;
	edge_id = "hw8";
	teleport_to_id = "sc3"
	},
/turf/exterior/concrete/reinforced/road,
/area/surface)
"k" = (
/turf/exterior/wall/ice,
/area/surface)
"l" = (
/obj/effect/decal/cleanable/dirt,
/obj/effect/decal/cleanable/dirt,
/obj/effect/decal/cleanable/molten_item,
/turf/exterior/concrete/reinforced/road,
/area/surface)
"n" = (
/obj/structure/railing/mapped{
	dir = 4
	},
/turf/exterior/surface,
/area/surface)
"o" = (
/obj/structure/railing/mapped,
/turf/simulated/open/exterior,
/area/surface)
"p" = (
/obj/structure/boulder,
/turf/exterior/surface,
/area/surface)
"q" = (
/obj/effect/overmap_edge{
	dir = 8;
	edge_id = "hw7";
	teleport_to_id = "sc2"
	},
/turf/exterior/concrete/reinforced/road,
/area/surface)
"r" = (
/obj/structure/railing/mapped{
	dir = 1
	},
/turf/simulated/open/exterior,
/area/surface)
"s" = (
/obj/structure/railing/mapped{
	dir = 4
	},
/turf/simulated/open/exterior,
/area/surface)
"t" = (
/obj/structure/railing/mapped,
/turf/exterior/surface,
/area/surface)
"u" = (
/obj/effect/overmap_edge{
	dir = 8;
	edge_id = "hw6";
	teleport_to_id = "sc1"
	},
/turf/exterior/concrete/reinforced/road,
/area/surface)
"v" = (
/obj/structure/railing/mapped{
	dir = 8
	},
/turf/simulated/open/exterior,
/area/surface)
"w" = (
/obj/item/mobile_ladder,
/turf/exterior/concrete/reinforced/road,
/area/surface)
"x" = (
/obj/effect/overmap_edge{
	dir = 8;
	edge_id = "hw10";
	teleport_to_id = "sc5"
	},
/turf/exterior/concrete/reinforced/road,
/area/surface)
"y" = (
/obj/structure/railing/mapped{
	dir = 4
	},
/obj/structure/railing/mapped{
	dir = 1
	},
/turf/simulated/open/exterior,
/area/surface)
"z" = (
/turf/exterior/concrete,
/area/surface)
"A" = (
/obj/effect/overmap_edge{
	dir = 4;
	edge_id = "hw4";
	teleport_to_id = "av4"
	},
/turf/exterior/concrete/reinforced/road,
/area/surface)
"B" = (
/turf/simulated/wall/r_wall,
/area/surface)
"C" = (
/obj/structure/railing,
/turf/simulated/open/exterior,
/area/surface)
"D" = (
/obj/effect/floor_decal/industrial/traffic/fulltile,
/obj/effect/overmap_edge{
	dir = 4;
	edge_id = "hw3";
	teleport_to_id = "av3"
	},
/turf/exterior/concrete/reinforced/road,
/area/surface)
"E" = (
/obj/effect/overmap_edge{
	dir = 4;
	edge_id = "hw1";
	teleport_to_id = "av1"
	},
/turf/exterior/concrete/reinforced/road,
/area/surface)
"F" = (
/obj/effect/decal/cleanable/ash,
/obj/effect/decal/cleanable/dirt,
/turf/exterior/concrete/reinforced/road,
/area/surface)
"G" = (
/obj/effect/overmap_edge{
	dir = 4;
	edge_id = "hw5";
	teleport_to_id = "av5"
	},
/turf/exterior/concrete/reinforced/road,
/area/surface)
"H" = (
/obj/effect/decal/remains,
/turf/exterior/surface,
/area/surface)
"I" = (
/obj/structure/lattice,
/turf/simulated/open/exterior,
/area/surface)
"J" = (
/obj/structure/stairs/long/west,
/obj/structure/railing/mapped,
/turf/exterior/surface,
/area/surface)
"K" = (
/obj/effect/decal/cleanable/ash,
/turf/exterior/surface,
/area/surface)
"M" = (
/obj/effect/overmap_edge{
	dir = 8;
	edge_id = "hw9";
	teleport_to_id = "sc4"
	},
/turf/exterior/concrete/reinforced/road,
/area/surface)
"N" = (
/obj/structure/railing/mapped{
	dir = 8
	},
/turf/exterior/concrete,
/area/surface)
"O" = (
/obj/effect/decal/cleanable/dirt,
/turf/exterior/concrete/reinforced/road,
/area/surface)
"P" = (
/obj/effect/decal/cleanable/dirt,
/turf/exterior/concrete,
/area/surface)
"Q" = (
/obj/effect/floor_decal/industrial/traffic/fulltile,
/turf/exterior/concrete/reinforced/road,
/area/surface)
"S" = (
/obj/effect/decal/cleanable/ash,
/obj/structure/boulder,
/turf/exterior/surface,
/area/surface)
"T" = (
/obj/effect/decal/cleanable/ash,
/obj/effect/decal/cleanable/dirt,
/obj/effect/decal/cleanable/dirt,
/obj/effect/decal/cleanable/dirt,
/turf/exterior/concrete/reinforced/road,
/area/surface)
"U" = (
/obj/item/stack/material/sheet/mapped/steel/five,
/turf/exterior/surface,
/area/surface)
"X" = (
/obj/effect/overmap_edge{
	dir = 4;
	edge_id = "hw2";
	teleport_to_id = "av2"
	},
/turf/exterior/concrete/reinforced/road,
/area/surface)
"Y" = (
/obj/item/stack/material/rods/ten,
/turf/exterior/surface,
/area/surface)
"Z" = (
/obj/structure/railing,
/turf/exterior/concrete,
/area/surface)

(1,1,1) = {"
a
a
k
a
a
a
a
a
a
a
a
a
a
a
a
a
a
k
a
a
a
a
a
a
a
a
a
a
a
a
"}
(2,1,1) = {"
a
a
k
a
a
a
a
a
a
a
a
a
a
B
a
a
a
k
k
a
a
a
a
a
a
a
a
a
a
a
"}
(3,1,1) = {"
a
a
k
a
a
a
a
a
a
a
a
a
a
a
a
a
a
a
k
a
a
a
a
a
a
a
a
a
a
a
"}
(4,1,1) = {"
a
a
k
a
a
a
a
a
a
n
a
a
a
a
a
a
a
a
k
a
a
a
a
a
a
a
a
a
a
a
"}
(5,1,1) = {"
a
a
k
a
a
a
a
a
t
J
a
a
a
a
a
a
a
a
k
k
a
a
a
a
a
a
a
a
a
a
"}
(6,1,1) = {"
a
a
k
k
a
a
a
a
t
t
a
a
a
a
a
a
a
a
a
k
a
a
a
a
a
a
a
a
a
a
"}
(7,1,1) = {"
a
a
a
k
a
a
a
a
a
a
a
a
a
a
a
a
a
a
a
k
a
a
a
a
a
a
a
a
a
a
"}
(8,1,1) = {"
a
a
a
k
a
a
a
a
a
a
a
a
a
a
a
a
a
a
a
k
k
a
a
a
a
a
a
a
a
a
"}
(9,1,1) = {"
a
a
a
k
a
a
a
a
a
a
a
a
a
B
a
a
a
a
a
a
k
a
a
a
a
a
a
a
a
a
"}
(10,1,1) = {"
a
a
a
k
a
a
a
p
a
a
a
a
a
a
a
a
a
a
a
a
k
a
a
a
a
a
a
a
a
a
"}
(11,1,1) = {"
a
a
a
k
a
a
a
a
a
a
a
a
a
a
a
a
a
a
a
a
k
k
a
a
a
a
a
a
a
a
"}
(12,1,1) = {"
a
a
a
k
a
a
a
a
a
a
a
a
a
a
a
a
a
a
a
a
k
k
a
a
a
a
a
a
a
a
"}
(13,1,1) = {"
a
a
a
k
a
a
a
a
a
a
a
a
a
a
a
a
a
a
a
a
a
k
a
a
a
a
a
a
a
a
"}
(14,1,1) = {"
a
a
a
k
a
a
a
a
a
a
a
a
a
a
a
a
a
a
a
a
a
k
a
a
a
a
a
a
a
a
"}
(15,1,1) = {"
a
a
a
k
a
a
a
a
a
a
a
a
a
a
a
a
a
a
a
a
a
k
a
a
a
a
a
a
a
a
"}
(16,1,1) = {"
a
a
a
k
a
a
a
a
a
a
a
a
a
B
a
a
a
a
a
a
a
k
k
a
a
a
a
a
a
a
"}
(17,1,1) = {"
a
a
a
k
a
a
a
a
a
a
a
a
a
a
a
a
a
a
a
a
a
k
k
a
a
a
a
a
a
a
"}
(18,1,1) = {"
a
a
a
k
a
a
a
a
a
a
a
a
a
a
a
a
a
a
a
p
a
k
k
a
a
a
a
a
a
a
"}
(19,1,1) = {"
a
a
a
k
a
a
a
a
a
a
a
a
a
a
a
a
a
a
a
a
a
k
k
a
a
a
a
a
a
a
"}
(20,1,1) = {"
a
a
a
k
k
a
a
a
a
a
a
a
a
a
a
a
a
a
a
a
a
a
k
a
a
a
a
a
a
a
"}
(21,1,1) = {"
a
a
a
a
k
a
a
a
a
a
a
a
a
a
a
a
a
a
a
a
a
a
k
k
a
a
a
a
a
a
"}
(22,1,1) = {"
a
a
a
a
k
a
a
a
p
a
a
a
a
a
a
a
a
a
a
a
a
a
a
k
k
a
a
a
a
a
"}
(23,1,1) = {"
a
a
a
a
k
a
a
a
a
a
a
a
a
B
a
a
a
a
a
a
a
a
a
a
k
a
a
a
a
a
"}
(24,1,1) = {"
a
a
a
a
k
a
a
a
a
a
a
a
a
a
a
a
a
a
a
a
a
a
a
a
k
a
a
a
a
a
"}
(25,1,1) = {"
a
a
a
a
k
a
a
a
a
a
a
a
a
a
a
a
a
a
a
a
a
a
a
a
k
a
a
a
a
a
"}
(26,1,1) = {"
a
a
a
a
k
a
a
a
a
a
a
a
a
a
a
a
a
a
a
a
a
a
a
a
k
a
a
a
a
a
"}
(27,1,1) = {"
a
a
a
a
k
a
a
a
a
a
a
a
a
a
a
a
a
a
a
a
a
a
a
k
k
a
a
a
a
a
"}
(28,1,1) = {"
a
a
a
a
k
a
a
a
a
a
a
a
a
a
a
a
a
a
a
a
a
a
a
k
a
a
a
a
a
a
"}
(29,1,1) = {"
a
a
a
a
k
a
a
a
a
a
a
a
a
a
a
a
a
a
a
a
a
a
a
k
a
a
a
a
a
a
"}
(30,1,1) = {"
a
a
a
a
k
a
a
a
a
a
a
a
a
B
a
a
a
a
a
a
a
a
a
k
a
a
a
a
a
a
"}
(31,1,1) = {"
a
a
a
a
k
a
a
a
p
a
a
a
a
a
a
a
a
a
a
a
a
a
a
k
a
a
a
a
a
a
"}
(32,1,1) = {"
a
a
a
a
k
a
a
a
a
a
a
a
a
a
a
a
a
a
a
a
a
a
k
k
a
a
a
a
a
a
"}
(33,1,1) = {"
a
a
a
a
k
a
a
a
a
a
a
a
a
a
a
a
a
p
a
a
a
a
k
k
a
a
a
a
a
a
"}
(34,1,1) = {"
a
a
a
a
k
k
a
a
a
a
a
p
a
a
a
a
a
a
a
a
a
k
k
a
a
a
a
a
a
a
"}
(35,1,1) = {"
a
a
a
a
a
k
a
a
a
a
a
a
a
a
a
a
a
a
a
a
k
k
k
a
a
a
a
a
a
a
"}
(36,1,1) = {"
a
a
a
a
a
k
a
a
a
a
a
a
a
a
a
a
a
a
a
a
k
k
a
a
a
a
a
a
a
a
"}
(37,1,1) = {"
a
a
a
a
a
k
a
a
a
a
a
a
a
B
a
a
a
a
a
k
k
a
a
a
a
a
a
a
a
a
"}
(38,1,1) = {"
a
a
a
a
k
k
a
a
a
a
a
a
a
a
a
a
a
a
a
a
k
k
a
a
a
a
a
a
a
a
"}
(39,1,1) = {"
a
a
a
k
k
a
a
a
a
a
a
a
a
a
a
a
a
a
a
a
a
k
k
a
a
a
a
a
a
a
"}
(40,1,1) = {"
a
a
a
k
a
a
a
a
a
a
a
H
a
a
a
a
a
a
a
a
a
a
k
k
a
a
a
a
a
a
"}
(41,1,1) = {"
a
a
a
k
a
a
a
a
a
a
a
a
a
a
a
a
a
a
a
a
a
a
a
k
k
a
a
a
a
a
"}
(42,1,1) = {"
a
a
a
k
a
a
a
a
a
a
a
a
a
a
a
a
a
a
a
a
a
a
a
a
k
a
a
a
a
a
"}
(43,1,1) = {"
a
a
a
k
a
a
a
a
a
a
a
a
a
a
a
k
k
a
a
a
a
a
a
a
k
k
a
a
a
a
"}
(44,1,1) = {"
a
a
a
k
a
a
a
a
k
k
a
a
a
B
a
a
k
k
a
a
a
a
a
a
a
k
a
a
a
a
"}
(45,1,1) = {"
a
a
k
k
a
a
a
a
k
a
a
a
a
a
a
a
a
k
k
a
a
a
a
a
a
k
a
a
a
a
"}
(46,1,1) = {"
a
a
k
a
a
a
a
k
k
a
a
a
a
p
a
a
a
a
k
a
a
a
a
a
a
k
k
a
a
a
"}
(47,1,1) = {"
a
a
k
a
a
a
a
k
a
a
H
a
a
a
a
a
a
a
a
H
a
a
a
a
a
a
k
a
a
a
"}
(48,1,1) = {"
a
a
k
a
a
a
a
k
a
U
a
a
h
U
p
K
h
a
a
a
U
a
a
a
a
a
k
a
a
a
"}
(49,1,1) = {"
a
a
k
a
a
a
a
k
a
a
a
Y
a
a
a
a
a
Y
a
a
a
a
a
a
a
a
k
a
a
a
"}
(50,1,1) = {"
a
a
k
a
a
a
a
k
a
a
a
a
a
a
Y
a
U
a
a
a
a
a
a
a
a
a
k
a
a
a
"}
(51,1,1) = {"
a
a
k
a
a
a
a
a
a
a
a
a
K
a
U
a
Y
a
S
a
a
a
a
a
a
a
k
a
a
a
"}
(52,1,1) = {"
a
a
k
a
a
a
a
a
a
p
a
U
a
a
h
a
a
a
a
a
a
a
a
H
a
a
k
a
a
a
"}
(53,1,1) = {"
a
a
a
k
a
a
a
a
a
a
a
a
a
a
a
Y
a
a
U
a
a
a
a
a
a
a
k
a
a
a
"}
(54,1,1) = {"
a
a
a
k
a
a
H
a
a
a
a
a
a
a
a
a
a
a
a
a
a
k
a
a
a
a
k
a
a
a
"}
(55,1,1) = {"
a
a
a
k
a
a
a
a
k
a
a
a
a
a
a
a
a
a
a
k
k
k
a
a
a
a
k
a
a
a
"}
(56,1,1) = {"
a
a
a
k
a
a
a
a
k
k
a
H
a
a
a
a
p
a
k
k
a
a
a
a
a
a
k
a
a
a
"}
(57,1,1) = {"
a
a
a
k
a
a
a
a
a
k
a
a
a
a
a
a
a
a
k
a
a
a
a
a
a
k
a
a
a
a
"}
(58,1,1) = {"
a
a
a
k
k
a
a
a
a
k
k
a
a
B
a
a
a
a
a
a
a
a
a
a
a
k
a
a
a
a
"}
(59,1,1) = {"
a
a
a
a
k
a
a
a
a
a
a
a
a
a
a
a
a
a
a
a
a
a
a
a
a
k
a
a
a
a
"}
(60,1,1) = {"
a
a
a
a
k
k
a
a
a
a
a
a
a
a
a
a
a
a
a
a
a
a
a
a
a
k
a
a
a
a
"}
(61,1,1) = {"
a
a
a
a
a
k
a
H
a
a
a
a
a
a
a
a
a
p
a
a
a
a
a
a
k
k
a
a
a
a
"}
(62,1,1) = {"
a
a
a
a
a
k
a
a
a
a
a
a
a
a
a
a
a
a
H
a
a
a
a
a
k
a
a
a
a
a
"}
(63,1,1) = {"
a
a
a
a
a
k
a
a
a
a
a
a
a
a
a
a
a
a
a
a
a
a
a
k
k
a
a
a
a
a
"}
(64,1,1) = {"
a
a
a
a
a
a
k
a
a
a
a
a
a
a
a
a
a
a
a
a
a
a
a
k
a
a
a
a
a
a
"}
(65,1,1) = {"
a
a
a
a
a
a
k
a
a
a
a
a
a
B
a
a
a
a
a
a
a
a
k
a
a
a
a
a
a
a
"}
(66,1,1) = {"
a
a
a
a
a
a
k
a
a
a
a
a
a
a
a
a
a
a
a
a
a
k
k
a
a
a
a
a
a
a
"}
(67,1,1) = {"
a
a
a
a
a
a
k
a
a
a
a
a
a
a
a
a
a
a
a
a
k
k
a
a
a
a
a
a
a
a
"}
(68,1,1) = {"
a
a
a
a
a
k
a
a
a
a
a
a
a
a
a
a
a
a
a
k
k
a
a
a
a
a
a
a
a
a
"}
(69,1,1) = {"
a
a
a
a
k
k
a
a
a
a
a
a
a
a
a
a
a
a
a
k
a
a
a
a
a
a
a
a
a
a
"}
(70,1,1) = {"
a
a
a
k
k
a
a
a
a
a
a
a
a
a
a
a
a
a
a
k
a
a
a
a
a
a
a
a
a
a
"}
(71,1,1) = {"
a
a
k
k
a
a
a
a
a
a
a
a
a
a
a
a
a
a
a
k
a
a
a
a
a
a
a
a
a
a
"}
(72,1,1) = {"
a
a
k
a
a
a
a
a
a
p
a
a
a
B
a
a
a
a
a
k
a
a
a
a
a
a
a
a
a
a
"}
(73,1,1) = {"
a
k
k
a
p
a
a
a
a
a
a
a
a
a
a
a
a
a
a
a
k
a
a
a
a
a
a
a
a
a
"}
(74,1,1) = {"
a
k
a
a
a
a
a
a
a
a
a
a
a
a
a
a
a
a
a
a
k
a
a
a
a
a
a
a
a
a
"}
(75,1,1) = {"
a
k
a
a
a
a
a
a
a
a
a
a
a
a
a
a
a
a
a
a
k
a
a
a
a
a
a
a
a
a
"}
(76,1,1) = {"
a
k
a
a
a
a
a
a
a
a
a
a
a
a
a
a
a
a
a
a
k
a
a
a
a
a
a
a
a
a
"}
(77,1,1) = {"
a
k
a
a
a
p
a
a
a
p
a
a
a
a
a
a
a
a
a
a
k
a
a
a
a
a
a
a
a
a
"}
(78,1,1) = {"
a
k
k
a
a
a
a
a
a
a
a
a
a
a
a
a
a
a
a
a
k
a
a
a
a
a
a
a
a
a
"}
(79,1,1) = {"
a
a
k
a
a
a
a
a
a
a
a
a
a
B
a
a
a
a
a
a
k
a
a
a
a
a
a
a
a
a
"}
(80,1,1) = {"
a
a
k
a
a
a
a
a
a
a
a
a
a
a
a
a
a
p
a
a
k
a
a
a
a
a
a
a
a
a
"}
(81,1,1) = {"
a
a
k
a
a
a
a
a
a
a
a
a
a
a
a
a
a
a
a
a
k
a
a
a
a
a
a
a
a
a
"}
(82,1,1) = {"
a
a
k
a
a
a
a
a
a
a
a
a
a
a
a
a
a
a
a
a
k
a
a
a
a
a
a
a
a
a
"}
(83,1,1) = {"
a
a
k
a
a
a
a
p
a
a
a
a
a
a
a
a
a
a
a
a
k
a
a
a
a
a
a
a
a
a
"}
(84,1,1) = {"
a
a
k
a
a
a
a
a
a
a
a
a
a
a
a
a
a
a
a
a
k
a
a
a
a
a
a
a
a
a
"}
(85,1,1) = {"
a
a
a
k
a
a
a
a
a
a
a
a
a
a
a
a
a
a
a
a
k
a
a
a
a
a
a
a
a
a
"}
(86,1,1) = {"
a
a
a
k
a
a
a
a
a
a
a
a
a
B
a
a
a
p
p
a
a
k
a
a
a
a
a
a
a
a
"}
(87,1,1) = {"
a
a
a
k
a
a
a
a
a
a
a
a
a
a
a
a
a
a
a
a
a
k
a
a
a
a
a
a
a
a
"}
(88,1,1) = {"
a
a
a
k
a
a
a
a
a
a
a
a
a
a
a
a
a
a
a
a
a
k
a
a
a
a
a
a
a
a
"}
(89,1,1) = {"
a
a
a
k
a
a
a
a
a
a
a
a
a
a
a
a
a
a
a
a
a
k
a
a
a
a
a
a
a
a
"}
(90,1,1) = {"
a
a
a
k
a
a
a
a
a
a
a
a
a
a
a
a
a
a
a
a
a
k
a
a
a
a
a
a
a
a
"}
(91,1,1) = {"
a
a
a
k
a
a
a
a
a
a
a
a
a
a
a
a
a
a
a
a
a
k
a
a
a
a
a
a
a
a
"}
(92,1,1) = {"
a
a
a
k
a
a
a
a
p
a
a
a
a
a
a
a
a
a
a
a
a
k
a
a
a
a
a
a
a
a
"}
(93,1,1) = {"
a
a
a
k
a
a
a
a
a
a
a
a
a
B
a
a
a
a
a
a
a
k
k
a
a
a
a
a
a
a
"}
(94,1,1) = {"
a
a
a
k
a
a
a
a
a
a
a
a
a
a
a
a
a
a
a
a
a
a
k
a
a
a
a
a
a
a
"}
(95,1,1) = {"
a
a
a
k
a
a
a
a
a
a
a
a
a
a
a
a
a
a
a
a
a
a
k
a
a
a
a
a
a
a
"}
(96,1,1) = {"
a
a
a
k
a
a
a
a
a
a
a
a
a
a
a
a
a
a
a
a
a
a
k
a
a
a
a
a
a
a
"}
(97,1,1) = {"
a
a
a
k
a
a
a
a
a
a
a
a
a
a
a
a
a
a
a
a
a
a
k
a
a
a
a
a
a
a
"}
(98,1,1) = {"
a
a
a
k
a
a
a
a
a
a
a
a
a
a
a
a
a
a
a
a
a
a
k
a
a
a
a
a
a
a
"}
(99,1,1) = {"
a
a
a
k
a
a
a
a
a
a
a
a
a
a
a
a
a
a
a
a
a
a
k
a
a
a
a
a
a
a
"}
(100,1,1) = {"
a
a
a
k
a
a
a
a
a
a
a
a
a
B
a
a
a
a
a
a
a
a
k
a
a
a
a
a
a
a
"}
(101,1,1) = {"
a
a
a
k
a
a
a
a
a
a
a
a
a
a
a
a
a
a
a
p
a
a
k
a
a
a
a
a
a
a
"}
(102,1,1) = {"
a
a
a
k
k
a
a
a
a
a
a
a
a
a
a
a
a
a
a
a
a
a
k
a
a
a
a
a
a
a
"}
(103,1,1) = {"
a
a
a
a
k
a
a
a
a
a
a
a
a
a
a
a
a
a
a
a
a
a
k
k
a
a
a
a
a
a
"}
(104,1,1) = {"
a
a
a
a
k
a
a
a
p
a
a
a
a
a
a
a
a
a
a
a
a
a
a
k
a
a
a
a
a
a
"}
(105,1,1) = {"
a
a
a
a
k
a
a
a
a
a
a
a
a
a
a
a
a
a
a
a
a
a
a
k
a
a
a
a
a
a
"}
(106,1,1) = {"
a
a
a
a
k
a
a
a
a
a
a
a
a
a
a
a
a
a
a
a
a
a
a
k
a
a
a
a
a
a
"}
(107,1,1) = {"
a
a
a
a
k
a
a
a
a
a
a
a
a
B
a
a
a
a
a
a
a
a
a
k
a
a
a
a
a
a
"}
(108,1,1) = {"
a
a
a
a
k
a
a
a
a
a
a
a
a
a
a
a
a
a
a
a
a
a
a
k
a
a
a
a
a
a
"}
(109,1,1) = {"
a
a
a
a
k
a
a
a
a
a
a
a
a
a
a
a
a
a
a
a
a
a
a
k
a
a
a
a
a
a
"}
(110,1,1) = {"
a
a
a
a
k
k
a
a
a
a
a
a
a
a
a
a
a
a
a
a
a
a
a
k
a
a
a
a
a
a
"}
(111,1,1) = {"
a
a
a
a
a
k
a
a
a
a
a
a
a
a
a
a
a
a
a
a
a
a
a
k
a
a
a
a
a
a
"}
(112,1,1) = {"
a
a
a
a
a
k
a
a
a
a
a
a
a
a
a
a
a
p
a
a
a
a
a
k
k
a
a
a
a
a
"}
(113,1,1) = {"
a
a
a
a
a
k
a
a
p
a
a
a
a
a
a
a
a
a
a
a
a
a
a
a
k
a
a
a
a
a
"}
(114,1,1) = {"
a
a
a
a
a
k
a
a
a
a
a
a
a
B
a
a
a
a
a
a
a
a
a
a
k
a
a
a
a
a
"}
(115,1,1) = {"
a
a
a
a
a
k
a
a
a
a
a
a
a
a
a
a
a
a
a
a
a
a
a
a
k
a
a
a
a
a
"}
(116,1,1) = {"
a
a
a
a
a
k
a
a
a
a
a
a
a
a
a
a
a
a
a
a
a
a
a
a
k
k
a
a
a
a
"}
(117,1,1) = {"
a
a
a
a
a
k
k
a
a
a
a
a
p
a
a
a
a
a
a
a
a
a
a
a
a
k
k
a
a
a
"}
(118,1,1) = {"
a
a
a
a
a
a
k
a
a
a
a
a
a
a
a
a
a
a
a
a
a
a
a
a
a
a
k
a
a
a
"}
(119,1,1) = {"
a
a
a
a
a
a
k
a
a
a
a
a
a
a
a
a
a
a
a
a
a
p
a
a
a
a
k
a
a
a
"}
(120,1,1) = {"
a
a
a
a
a
a
k
a
a
a
a
a
a
a
a
a
a
a
a
a
a
a
a
a
a
a
k
a
a
a
"}

(1,1,2) = {"
k
k
a
f
f
f
f
f
f
C
z
E
X
D
A
G
Z
a
k
k
k
k
k
k
k
k
k
k
k
k
"}
(2,1,2) = {"
k
k
a
f
f
f
f
f
f
C
z
d
d
Q
d
d
Z
a
a
k
k
k
k
k
k
k
k
k
k
k
"}
(3,1,2) = {"
k
k
a
f
f
f
f
f
f
C
z
d
d
Q
d
w
Z
f
a
k
k
k
k
k
k
k
k
k
k
k
"}
(4,1,2) = {"
k
k
a
f
f
f
f
f
C
N
z
d
d
d
d
d
Z
f
a
k
k
k
k
k
k
k
k
k
k
k
"}
(5,1,2) = {"
k
k
a
f
f
f
f
f
C
f
z
d
d
d
d
d
Z
f
a
a
k
k
k
k
k
k
k
k
k
k
"}
(6,1,2) = {"
k
k
a
a
f
f
f
f
o
s
z
d
w
d
d
d
Z
f
f
a
k
k
k
k
k
k
k
k
k
k
"}
(7,1,2) = {"
k
k
k
a
f
f
f
f
f
C
z
d
d
d
d
d
Z
f
f
a
k
k
k
k
k
k
k
k
k
k
"}
(8,1,2) = {"
k
k
k
a
f
f
f
f
f
C
z
d
d
Q
d
d
Z
f
f
a
a
k
k
k
k
k
k
k
k
k
"}
(9,1,2) = {"
k
k
k
a
f
f
f
f
f
C
z
d
d
Q
d
d
Z
f
f
f
a
k
k
k
k
k
k
k
k
k
"}
(10,1,2) = {"
k
k
k
a
f
f
f
f
f
C
z
d
d
Q
d
d
Z
f
f
f
a
k
k
k
k
k
k
k
k
k
"}
(11,1,2) = {"
k
k
k
a
f
f
f
f
f
C
z
d
d
d
d
d
Z
f
f
f
a
a
k
k
k
k
k
k
k
k
"}
(12,1,2) = {"
k
k
k
a
f
f
f
f
f
C
z
d
d
d
d
d
Z
f
f
f
a
a
k
k
k
k
k
k
k
k
"}
(13,1,2) = {"
k
k
k
a
f
f
f
f
f
C
z
d
d
d
d
d
Z
f
f
f
f
a
k
k
k
k
k
k
k
k
"}
(14,1,2) = {"
k
k
k
a
f
f
f
f
f
C
z
d
d
d
d
d
Z
f
f
f
f
a
k
k
k
k
k
k
k
k
"}
(15,1,2) = {"
k
k
k
a
f
f
f
f
f
C
z
d
d
Q
d
d
Z
f
f
f
f
a
k
k
k
k
k
k
k
k
"}
(16,1,2) = {"
k
k
k
a
f
f
f
f
f
C
z
d
d
Q
d
d
Z
f
f
f
f
a
a
k
k
k
k
k
k
k
"}
(17,1,2) = {"
k
k
k
a
f
f
f
f
f
C
z
d
d
Q
d
d
Z
f
f
f
f
a
a
k
k
k
k
k
k
k
"}
(18,1,2) = {"
k
k
k
a
f
f
f
f
f
C
z
d
d
d
d
d
Z
f
f
f
f
a
a
k
k
k
k
k
k
k
"}
(19,1,2) = {"
k
k
k
a
f
f
f
f
f
C
z
d
d
d
d
d
Z
f
f
f
f
a
a
k
k
k
k
k
k
k
"}
(20,1,2) = {"
k
k
k
a
a
f
f
f
f
C
z
d
d
d
d
d
Z
f
f
f
f
f
a
k
k
k
k
k
k
k
"}
(21,1,2) = {"
k
k
k
k
a
f
f
f
f
C
z
d
d
d
d
d
Z
f
f
f
f
f
a
a
k
k
k
k
k
k
"}
(22,1,2) = {"
k
k
k
k
a
f
f
f
f
C
z
d
d
Q
d
d
Z
f
f
f
f
f
f
a
a
k
k
k
k
k
"}
(23,1,2) = {"
k
k
k
k
a
f
f
f
f
C
z
d
d
Q
d
d
Z
f
f
f
f
f
f
f
a
k
k
k
k
k
"}
(24,1,2) = {"
k
k
k
k
a
f
f
f
f
C
z
d
d
Q
d
d
Z
f
f
f
f
f
f
f
a
k
k
k
k
k
"}
(25,1,2) = {"
k
k
k
k
a
f
f
f
f
C
z
d
d
d
d
d
Z
f
f
f
f
f
f
f
a
k
k
k
k
k
"}
(26,1,2) = {"
k
k
k
k
a
f
f
f
f
C
z
d
d
d
d
d
Z
f
f
f
f
f
f
f
a
k
k
k
k
k
"}
(27,1,2) = {"
k
k
k
k
a
f
f
f
f
C
z
d
d
d
d
d
Z
f
f
f
f
f
f
a
a
k
k
k
k
k
"}
(28,1,2) = {"
k
k
k
k
a
f
f
f
f
C
z
d
d
d
d
d
Z
f
f
f
f
f
f
a
k
k
k
k
k
k
"}
(29,1,2) = {"
k
k
k
k
a
f
f
f
f
C
z
d
d
Q
d
d
Z
f
f
f
f
f
f
a
k
k
k
k
k
k
"}
(30,1,2) = {"
k
k
k
k
a
f
f
f
f
C
z
d
d
Q
d
d
Z
f
f
f
f
f
f
a
k
k
k
k
k
k
"}
(31,1,2) = {"
k
k
k
k
a
f
f
f
f
C
z
d
d
Q
d
d
Z
f
f
f
f
f
f
a
k
k
k
k
k
k
"}
(32,1,2) = {"
k
k
k
k
a
f
f
f
f
C
z
d
d
d
d
d
Z
f
f
f
f
f
a
a
k
k
k
k
k
k
"}
(33,1,2) = {"
k
k
k
k
a
f
f
f
f
C
z
d
d
d
d
d
Z
f
f
f
f
f
a
a
k
k
k
k
k
k
"}
(34,1,2) = {"
k
k
k
k
a
a
f
f
f
C
z
d
d
d
d
d
Z
f
f
f
f
a
a
k
k
k
k
k
k
k
"}
(35,1,2) = {"
k
k
k
k
k
a
f
f
f
C
z
d
d
d
d
d
Z
f
f
f
a
a
a
k
k
k
k
k
k
k
"}
(36,1,2) = {"
k
k
k
k
k
a
f
f
f
C
z
d
d
Q
d
d
Z
f
f
f
a
a
k
k
k
k
k
k
k
k
"}
(37,1,2) = {"
k
k
k
k
k
a
f
f
f
C
z
d
d
Q
d
d
Z
f
f
a
a
k
k
k
k
k
k
k
k
k
"}
(38,1,2) = {"
k
k
k
k
a
a
f
f
f
C
z
d
d
Q
d
d
Z
f
f
f
a
a
k
k
k
k
k
k
k
k
"}
(39,1,2) = {"
k
k
k
a
a
f
f
f
f
C
z
d
d
d
d
d
Z
f
f
f
f
a
a
k
k
k
k
k
k
k
"}
(40,1,2) = {"
k
k
k
a
f
f
f
f
f
C
z
d
d
d
d
d
Z
f
f
f
f
f
a
a
k
k
k
k
k
k
"}
(41,1,2) = {"
k
k
k
a
f
f
f
f
f
C
z
d
d
d
d
d
Z
f
f
f
f
f
f
a
a
k
k
k
k
k
"}
(42,1,2) = {"
k
k
k
a
f
f
f
f
f
C
z
d
d
d
d
d
Z
f
f
f
f
f
f
f
a
k
k
k
k
k
"}
(43,1,2) = {"
k
k
k
a
f
f
f
f
f
C
z
d
d
Q
d
d
Z
f
f
f
f
f
f
f
a
a
k
k
k
k
"}
(44,1,2) = {"
k
k
k
a
f
f
f
f
f
C
z
d
d
Q
O
e
Z
f
f
f
f
f
f
f
f
a
k
k
k
k
"}
(45,1,2) = {"
k
k
a
a
f
f
f
f
f
C
z
O
O
Q
d
O
Z
s
f
f
f
f
f
f
f
a
k
k
k
k
"}
(46,1,2) = {"
k
k
a
f
f
f
f
f
f
C
P
O
g
l
O
I
I
f
f
f
f
f
f
f
f
a
a
k
k
k
"}
(47,1,2) = {"
k
k
a
f
f
f
f
f
s
b
I
I
F
O
I
I
f
f
f
f
f
f
f
f
f
f
a
k
k
k
"}
(48,1,2) = {"
k
k
a
f
f
f
f
f
r
f
f
I
f
I
I
f
f
f
f
f
f
f
f
f
f
f
a
k
k
k
"}
(49,1,2) = {"
k
k
a
f
f
f
f
f
f
f
I
I
f
I
f
f
f
f
f
o
f
f
f
f
f
f
a
k
k
k
"}
(50,1,2) = {"
k
k
a
f
f
f
f
f
f
f
I
f
f
f
f
f
f
f
f
o
f
f
f
f
f
f
a
k
k
k
"}
(51,1,2) = {"
k
k
a
f
f
f
f
f
f
y
I
f
f
f
I
I
I
f
o
v
f
f
f
f
f
f
a
k
k
k
"}
(52,1,2) = {"
k
k
a
a
f
f
f
f
f
C
f
f
I
I
I
g
Z
v
v
f
f
f
f
f
f
f
a
k
k
k
"}
(53,1,2) = {"
k
k
k
a
f
f
f
f
f
C
f
f
I
d
d
O
Z
f
f
f
f
f
f
f
f
f
a
k
k
k
"}
(54,1,2) = {"
k
k
k
a
f
f
f
f
f
C
f
f
d
O
T
d
Z
f
f
f
f
f
f
f
f
f
a
k
k
k
"}
(55,1,2) = {"
k
k
k
a
f
f
f
f
f
C
P
d
O
c
O
d
Z
f
f
f
f
f
f
f
f
f
a
k
k
k
"}
(56,1,2) = {"
k
k
k
a
f
f
f
f
f
C
P
O
O
d
d
d
Z
f
f
f
f
f
f
f
f
a
a
k
k
k
"}
(57,1,2) = {"
k
k
k
a
f
f
f
f
f
C
z
O
d
Q
d
d
Z
f
f
f
f
f
f
f
f
a
k
k
k
k
"}
(58,1,2) = {"
k
k
k
a
a
f
f
f
f
C
z
O
d
Q
d
d
Z
f
f
f
f
f
f
f
f
a
k
k
k
k
"}
(59,1,2) = {"
k
k
k
k
a
f
f
f
f
C
z
d
d
Q
d
d
Z
f
f
f
f
f
f
f
f
a
k
k
k
k
"}
(60,1,2) = {"
k
k
k
k
a
a
f
f
f
C
z
d
d
d
d
d
Z
f
f
f
f
f
f
f
f
a
k
k
k
k
"}
(61,1,2) = {"
k
k
k
k
k
a
f
f
f
C
z
d
d
d
d
d
Z
f
f
f
f
f
f
f
a
a
k
k
k
k
"}
(62,1,2) = {"
k
k
k
k
k
a
f
f
f
C
z
d
d
d
d
d
Z
f
f
f
f
f
f
f
a
k
k
k
k
k
"}
(63,1,2) = {"
k
k
k
k
k
a
a
f
f
C
z
d
d
d
d
d
Z
f
f
f
f
f
f
a
a
k
k
k
k
k
"}
(64,1,2) = {"
k
k
k
k
k
k
a
f
f
C
z
d
d
Q
d
d
Z
f
f
f
f
f
a
a
k
k
k
k
k
k
"}
(65,1,2) = {"
k
k
k
k
k
k
a
f
f
C
z
d
d
Q
d
d
Z
f
f
f
f
f
a
k
k
k
k
k
k
k
"}
(66,1,2) = {"
k
k
k
k
k
k
a
f
f
C
z
d
d
Q
d
d
Z
f
f
f
f
a
a
k
k
k
k
k
k
k
"}
(67,1,2) = {"
k
k
k
k
k
k
a
f
f
C
z
d
d
d
d
d
Z
f
f
f
a
a
k
k
k
k
k
k
k
k
"}
(68,1,2) = {"
k
k
k
k
k
k
a
f
f
C
z
d
d
d
d
d
Z
f
f
a
a
k
k
k
k
k
k
k
k
k
"}
(69,1,2) = {"
k
k
k
k
a
a
a
f
f
C
z
d
d
d
d
d
Z
f
f
a
k
k
k
k
k
k
k
k
k
k
"}
(70,1,2) = {"
k
k
k
a
a
f
f
f
f
C
z
d
d
d
d
d
Z
f
f
a
k
k
k
k
k
k
k
k
k
k
"}
(71,1,2) = {"
k
k
a
a
f
f
f
f
f
C
z
d
d
Q
d
d
Z
f
f
a
k
k
k
k
k
k
k
k
k
k
"}
(72,1,2) = {"
k
k
a
f
f
f
f
f
f
C
z
d
d
Q
d
d
Z
f
f
a
k
k
k
k
k
k
k
k
k
k
"}
(73,1,2) = {"
k
a
a
f
f
f
f
f
f
C
z
d
d
Q
d
d
Z
f
f
a
a
k
k
k
k
k
k
k
k
k
"}
(74,1,2) = {"
k
a
a
f
f
f
f
f
f
C
z
d
d
d
d
d
Z
f
f
f
a
k
k
k
k
k
k
k
k
k
"}
(75,1,2) = {"
k
a
f
f
f
f
f
f
f
C
z
d
d
d
d
d
Z
f
f
f
a
k
k
k
k
k
k
k
k
k
"}
(76,1,2) = {"
k
a
f
f
f
f
f
f
f
C
z
d
d
d
d
d
Z
f
f
f
a
k
k
k
k
k
k
k
k
k
"}
(77,1,2) = {"
k
a
f
f
f
f
f
f
f
C
z
d
d
d
d
d
Z
f
f
f
a
k
k
k
k
k
k
k
k
k
"}
(78,1,2) = {"
k
a
a
f
f
f
f
f
f
C
z
d
d
Q
d
d
Z
f
f
f
a
k
k
k
k
k
k
k
k
k
"}
(79,1,2) = {"
k
k
a
f
f
f
f
f
f
C
z
d
d
Q
d
d
Z
f
f
f
a
k
k
k
k
k
k
k
k
k
"}
(80,1,2) = {"
k
k
a
f
f
f
f
f
f
C
z
d
d
Q
d
d
Z
f
f
f
a
k
k
k
k
k
k
k
k
k
"}
(81,1,2) = {"
k
k
a
f
f
f
f
f
f
C
z
d
d
d
d
d
Z
f
f
f
a
k
k
k
k
k
k
k
k
k
"}
(82,1,2) = {"
k
k
a
f
f
f
f
f
f
C
z
d
d
d
d
d
Z
f
f
f
a
k
k
k
k
k
k
k
k
k
"}
(83,1,2) = {"
k
k
a
f
f
f
f
f
f
C
z
d
d
d
d
d
Z
f
f
f
a
k
k
k
k
k
k
k
k
k
"}
(84,1,2) = {"
k
k
a
a
f
f
f
f
f
C
z
d
d
d
d
d
Z
f
f
f
a
k
k
k
k
k
k
k
k
k
"}
(85,1,2) = {"
k
k
k
a
f
f
f
f
f
C
z
d
d
Q
d
d
Z
f
f
f
a
k
k
k
k
k
k
k
k
k
"}
(86,1,2) = {"
k
k
k
a
f
f
f
f
f
C
z
d
d
Q
d
d
Z
f
f
f
a
a
k
k
k
k
k
k
k
k
"}
(87,1,2) = {"
k
k
k
a
f
f
f
f
f
C
z
d
d
Q
d
d
Z
f
f
f
f
a
k
k
k
k
k
k
k
k
"}
(88,1,2) = {"
k
k
k
a
f
f
f
f
f
C
z
d
d
d
d
d
Z
f
f
f
f
a
k
k
k
k
k
k
k
k
"}
(89,1,2) = {"
k
k
k
a
f
f
f
f
f
C
z
d
d
d
d
d
Z
f
f
f
f
a
k
k
k
k
k
k
k
k
"}
(90,1,2) = {"
k
k
k
a
f
f
f
f
f
C
z
d
d
d
d
d
Z
f
f
f
f
a
k
k
k
k
k
k
k
k
"}
(91,1,2) = {"
k
k
k
a
f
f
f
f
f
C
z
d
d
d
d
d
Z
f
f
f
f
a
k
k
k
k
k
k
k
k
"}
(92,1,2) = {"
k
k
k
a
f
f
f
f
f
C
z
d
d
Q
d
d
Z
f
f
f
f
a
k
k
k
k
k
k
k
k
"}
(93,1,2) = {"
k
k
k
a
f
f
f
f
f
C
z
d
d
Q
d
d
Z
f
f
f
f
a
a
k
k
k
k
k
k
k
"}
(94,1,2) = {"
k
k
k
a
f
f
f
f
f
C
z
d
d
Q
d
d
Z
f
f
f
f
f
a
k
k
k
k
k
k
k
"}
(95,1,2) = {"
k
k
k
a
f
f
f
f
f
C
z
d
d
d
d
d
Z
f
f
f
f
f
a
k
k
k
k
k
k
k
"}
(96,1,2) = {"
k
k
k
a
f
f
f
f
f
C
z
d
d
d
d
d
Z
f
f
f
f
f
a
k
k
k
k
k
k
k
"}
(97,1,2) = {"
k
k
k
a
f
f
f
f
f
C
z
d
d
d
d
d
Z
f
f
f
f
f
a
k
k
k
k
k
k
k
"}
(98,1,2) = {"
k
k
k
a
f
f
f
f
f
C
z
d
d
d
d
d
Z
f
f
f
f
f
a
k
k
k
k
k
k
k
"}
(99,1,2) = {"
k
k
k
a
f
f
f
f
f
C
z
d
d
Q
d
d
Z
f
f
f
f
f
a
k
k
k
k
k
k
k
"}
(100,1,2) = {"
k
k
k
a
f
f
f
f
f
C
z
d
d
Q
d
d
Z
f
f
f
f
f
a
k
k
k
k
k
k
k
"}
(101,1,2) = {"
k
k
k
a
f
f
f
f
f
C
z
d
d
Q
d
d
Z
f
f
f
f
f
a
k
k
k
k
k
k
k
"}
(102,1,2) = {"
k
k
k
a
a
f
f
f
f
C
z
d
d
d
d
d
Z
f
f
f
f
f
a
k
k
k
k
k
k
k
"}
(103,1,2) = {"
k
k
k
k
a
f
f
f
f
C
z
d
d
d
d
d
Z
f
f
f
f
f
a
a
k
k
k
k
k
k
"}
(104,1,2) = {"
k
k
k
k
a
f
f
f
f
C
z
d
d
d
d
d
Z
f
f
f
f
f
f
a
k
k
k
k
k
k
"}
(105,1,2) = {"
k
k
k
k
a
f
f
f
f
C
z
d
d
d
d
d
Z
f
f
f
f
f
f
a
k
k
k
k
k
k
"}
(106,1,2) = {"
k
k
k
k
a
f
f
f
f
C
z
d
d
Q
d
d
Z
f
f
f
f
f
f
a
k
k
k
k
k
k
"}
(107,1,2) = {"
k
k
k
k
a
f
f
f
f
C
z
d
d
Q
d
d
Z
f
f
f
f
f
f
a
k
k
k
k
k
k
"}
(108,1,2) = {"
k
k
k
k
a
f
f
f
f
C
z
d
d
Q
d
d
Z
f
f
f
f
f
f
a
k
k
k
k
k
k
"}
(109,1,2) = {"
k
k
k
k
a
f
f
f
f
C
z
d
d
d
d
d
Z
f
f
f
f
f
f
a
k
k
k
k
k
k
"}
(110,1,2) = {"
k
k
k
k
a
a
f
f
f
C
z
d
d
d
d
d
Z
f
f
f
f
f
f
a
k
k
k
k
k
k
"}
(111,1,2) = {"
k
k
k
k
k
a
f
f
f
C
z
d
d
d
d
d
Z
f
f
f
f
f
f
a
k
k
k
k
k
k
"}
(112,1,2) = {"
k
k
k
k
k
a
f
f
f
C
z
d
d
d
d
d
Z
f
f
f
f
f
f
a
a
k
k
k
k
k
"}
(113,1,2) = {"
k
k
k
k
k
a
f
f
f
C
z
d
d
Q
d
d
Z
f
f
f
f
f
f
f
a
k
k
k
k
k
"}
(114,1,2) = {"
k
k
k
k
k
a
f
f
f
C
z
d
d
Q
d
d
Z
f
f
f
f
f
f
f
a
k
k
k
k
k
"}
(115,1,2) = {"
k
k
k
k
k
a
f
f
f
C
z
d
d
Q
d
d
Z
f
f
f
f
f
f
f
a
k
k
k
k
k
"}
(116,1,2) = {"
k
k
k
k
k
a
f
f
f
C
z
d
d
d
d
d
Z
f
f
f
f
f
f
f
a
a
k
k
k
k
"}
(117,1,2) = {"
k
k
k
k
k
a
a
f
f
C
z
d
d
d
d
d
Z
f
f
f
f
f
f
f
f
a
a
k
k
k
"}
(118,1,2) = {"
k
k
k
k
k
k
a
f
f
C
z
d
d
d
d
d
Z
f
f
f
f
f
f
f
f
f
a
k
k
k
"}
(119,1,2) = {"
k
k
k
k
k
k
a
f
f
C
z
d
d
d
d
d
Z
f
f
f
f
f
f
f
f
f
a
k
k
k
"}
(120,1,2) = {"
k
k
k
k
k
k
a
f
f
C
z
u
q
j
M
x
Z
f
f
f
f
f
f
f
f
f
a
k
k
k
"}
