//MAP CONVERTED BY dmm2tgm.py THIS HEADER COMMENT PREVENTS RECONVERSION, DO NOT REMOVE
"a" = (
/turf/exterior/surface,
/area/surface)
"b" = (
/obj/structure/railing/mapped,
/obj/structure/railing/mapped{
	dir = 4
	},
/turf/simulated/open/exterior,
/area/surface)
"c" = (
/obj/effect/decal/cleanable/dirt,
/obj/effect/decal/cleanable/dirt,
/obj/effect/decal/cleanable/dirt,
/turf/simulated/floor/concrete/black/surface,
/area/surface)
"d" = (
/turf/simulated/floor/concrete/black/surface,
/area/surface)
"e" = (
/obj/effect/decal/cleanable/ash,
/obj/effect/decal/cleanable/dirt,
/obj/effect/decal/cleanable/dirt,
/turf/simulated/floor/concrete/black/surface,
/area/surface)
"f" = (
/turf/simulated/open/exterior,
/area/surface)
"g" = (
/obj/effect/decal/cleanable/dirt,
/obj/effect/decal/cleanable/dirt,
/turf/simulated/floor/concrete/black/surface,
/area/surface)
"h" = (
/obj/structure/girder,
/turf/exterior/surface,
/area/surface)
"i" = (
/obj/item/mobile_ladder,
/obj/structure/lattice,
/turf/simulated/open/exterior,
/area/surface)
"j" = (
/obj/effect/floor_decal/industrial/traffic/fulltile,
/obj/effect/overmap_edge{
	name = "WEHS Skyscraper";
	teleport_to_id = "WEHS_west";
	edge_id = "road_1_east"
	},
/turf/simulated/floor/concrete/black/surface,
/area/surface)
"k" = (
/turf/exterior/wall/ice,
/area/surface)
"l" = (
/obj/effect/decal/cleanable/dirt,
/obj/effect/decal/cleanable/dirt,
/obj/effect/decal/cleanable/molten_item,
/turf/simulated/floor/concrete/black/surface,
/area/surface)
"m" = (
/obj/effect/floor_decal/industrial/traffic/fulltile,
/obj/effect/overmap_edge{
	name = "'Serenity' Shelter";
	teleport_to_id = "serenity_east";
	edge_id = "road_1_west"
	},
/turf/simulated/floor/concrete/black/surface,
/area/surface)
"n" = (
/obj/structure/railing/mapped{
	dir = 4
	},
/turf/exterior/surface,
/area/surface)
"o" = (
/obj/structure/railing/mapped,
/turf/simulated/open/exterior,
/area/surface)
"p" = (
/obj/structure/boulder,
/turf/exterior/surface,
/area/surface)
"q" = (
/turf/space,
/area/surface)
"r" = (
/obj/structure/railing/mapped{
	dir = 1
	},
/obj/structure/lattice,
/turf/simulated/open/exterior,
/area/surface)
"s" = (
/obj/structure/railing/mapped{
	dir = 4
	},
/turf/simulated/open/exterior,
/area/surface)
"t" = (
/obj/structure/railing/mapped,
/turf/exterior/surface,
/area/surface)
"u" = (
/obj/abstract/map_data/example{
	height = 2
	},
/turf/unsimulated/map_edge,
/area/surface)
"v" = (
/obj/structure/railing/mapped{
	dir = 8
	},
/turf/simulated/open/exterior,
/area/surface)
"w" = (
/obj/item/mobile_ladder,
/turf/simulated/floor/concrete/black/surface,
/area/surface)
"x" = (
/obj/effect/overmap_edge{
	name = "'Serenity' Shelter";
	teleport_to_id = "serenity_east";
	edge_id = "road_1_west"
	},
/turf/simulated/floor/concrete/surface,
/area/surface)
"y" = (
/obj/structure/railing/mapped{
	dir = 4
	},
/obj/structure/railing/mapped{
	dir = 1
	},
/turf/simulated/open/exterior,
/area/surface)
"z" = (
/turf/simulated/floor/concrete/surface,
/area/surface)
"A" = (
/obj/abstract/level_data_spawner/player,
/turf/unsimulated/map_edge,
/area/surface)
"B" = (
/turf/simulated/wall/r_wall,
/area/surface)
"C" = (
/obj/effect/overmap_edge{
	name = "WEHS Skyscraper";
	teleport_to_id = "WEHS_west";
	edge_id = "road_1_east"
	},
/turf/simulated/floor/concrete/surface,
/area/surface)
"D" = (
/obj/structure/lattice,
/obj/structure/railing/mapped{
	dir = 8
	},
/turf/simulated/open/exterior,
/area/surface)
"E" = (
/turf/unsimulated/map_edge,
/area/surface)
"F" = (
/obj/effect/decal/cleanable/ash,
/obj/effect/decal/cleanable/dirt,
/turf/simulated/floor/concrete/black/surface,
/area/surface)
"G" = (
/obj/structure/railing/mapped,
/obj/structure/lattice,
/obj/effect/overmap_edge{
	name = "WEHS Skyscraper";
	teleport_to_id = "WEHS_west";
	edge_id = "road_1_east"
	},
/turf/simulated/open/exterior,
/area/surface)
"H" = (
/obj/effect/decal/remains,
/turf/exterior/surface,
/area/surface)
"I" = (
/obj/structure/lattice,
/turf/simulated/open/exterior,
/area/surface)
"J" = (
/obj/structure/stairs/long/west,
/obj/structure/railing/mapped,
/turf/exterior/surface,
/area/surface)
"K" = (
/obj/effect/decal/cleanable/ash,
/turf/exterior/surface,
/area/surface)
"L" = (
/obj/structure/lattice,
/obj/effect/overmap_edge{
	name = "WEHS Skyscraper";
	teleport_to_id = "WEHS_west";
	edge_id = "road_1_east"
	},
/turf/simulated/open/exterior,
/area/surface)
"M" = (
/obj/structure/railing/mapped,
/obj/structure/lattice,
/turf/simulated/open/exterior,
/area/surface)
"N" = (
/obj/structure/railing/mapped{
	dir = 8
	},
/turf/simulated/floor/concrete/surface,
/area/surface)
"O" = (
/obj/effect/decal/cleanable/dirt,
/turf/simulated/floor/concrete/black/surface,
/area/surface)
"P" = (
/obj/effect/decal/cleanable/dirt,
/turf/simulated/floor/concrete/surface,
/area/surface)
"Q" = (
/obj/effect/floor_decal/industrial/traffic/fulltile,
/turf/simulated/floor/concrete/black/surface,
/area/surface)
"R" = (
/obj/effect/overmap_edge{
	name = "WEHS Skyscraper";
	teleport_to_id = "WEHS_west";
	edge_id = "road_1_east"
	},
/turf/simulated/floor/concrete/black/surface,
/area/surface)
"S" = (
/obj/effect/decal/cleanable/ash,
/obj/structure/boulder,
/turf/exterior/surface,
/area/surface)
"T" = (
/obj/effect/decal/cleanable/ash,
/obj/effect/decal/cleanable/dirt,
/obj/effect/decal/cleanable/dirt,
/obj/effect/decal/cleanable/dirt,
/turf/simulated/floor/concrete/black/surface,
/area/surface)
"U" = (
/obj/item/stack/material/sheet/mapped/steel/five,
/turf/exterior/surface,
/area/surface)
"V" = (
/obj/effect/overmap_edge{
	name = "'Serenity' Shelter";
	teleport_to_id = "serenity_east";
	edge_id = "road_1_west"
	},
/turf/simulated/floor/concrete/black/surface,
/area/surface)
"W" = (
/obj/structure/railing/mapped{
	dir = 4
	},
/turf/simulated/floor/concrete/surface,
/area/surface)
"X" = (
/obj/structure/railing/mapped,
/obj/effect/overmap_edge{
	name = "'Serenity' Shelter";
	teleport_to_id = "serenity_east";
	edge_id = "road_1_west"
	},
/turf/simulated/floor/concrete/surface,
/area/surface)
"Y" = (
/obj/item/stack/material/rods/ten,
/turf/exterior/surface,
/area/surface)
"Z" = (
/obj/structure/railing/mapped,
/turf/simulated/floor/concrete/surface,
/area/surface)

(1,1,1) = {"
E
E
E
E
E
E
E
E
E
E
E
E
E
E
E
E
E
E
E
E
E
E
E
E
E
E
E
E
E
E
"}
(2,1,1) = {"
E
k
k
a
a
a
a
a
a
a
a
a
a
B
a
a
a
k
k
k
k
k
k
k
k
k
k
k
k
A
"}
(3,1,1) = {"
E
k
k
a
a
a
a
a
a
a
a
a
a
a
a
a
a
a
k
k
k
k
k
k
k
k
k
k
k
E
"}
(4,1,1) = {"
E
k
k
a
a
a
a
a
a
n
a
a
a
a
a
a
a
a
k
k
k
k
k
k
k
k
k
k
k
E
"}
(5,1,1) = {"
E
k
k
a
a
a
a
a
t
J
a
a
a
a
a
a
a
a
k
k
k
k
k
k
k
k
k
k
k
E
"}
(6,1,1) = {"
E
k
k
k
a
a
a
a
t
t
a
a
a
a
a
a
a
a
a
k
k
k
k
k
k
k
k
k
k
E
"}
(7,1,1) = {"
E
k
k
k
a
a
a
a
a
a
a
a
a
a
a
a
a
a
a
k
k
k
k
k
k
k
k
k
k
E
"}
(8,1,1) = {"
E
k
k
k
a
a
a
a
a
a
a
a
a
a
a
a
a
a
a
k
k
k
k
k
k
k
k
k
k
E
"}
(9,1,1) = {"
E
k
k
k
a
a
a
a
a
a
a
a
a
B
a
a
a
a
a
a
k
k
k
k
k
k
k
k
k
E
"}
(10,1,1) = {"
E
k
k
k
a
a
a
p
a
a
a
a
a
a
a
a
a
a
a
a
k
k
k
k
k
k
k
k
k
E
"}
(11,1,1) = {"
E
k
k
k
a
a
a
a
a
a
a
a
a
a
a
a
a
a
a
a
k
k
k
k
k
k
k
k
k
E
"}
(12,1,1) = {"
E
k
k
k
a
a
a
a
a
a
a
a
a
a
a
a
a
a
a
a
k
k
k
k
k
k
k
k
k
E
"}
(13,1,1) = {"
E
k
k
k
a
a
a
a
a
a
a
a
a
a
a
a
a
a
a
a
a
k
k
k
k
k
k
k
k
E
"}
(14,1,1) = {"
E
k
k
k
a
a
a
a
a
a
a
a
a
a
a
a
a
a
a
a
a
k
k
k
k
k
k
k
k
E
"}
(15,1,1) = {"
E
k
k
k
a
a
a
a
a
a
a
a
a
a
a
a
a
a
a
a
a
k
k
k
k
k
k
k
k
E
"}
(16,1,1) = {"
E
k
k
k
a
a
a
a
a
a
a
a
a
B
a
a
a
a
a
a
a
k
k
k
k
k
k
k
k
E
"}
(17,1,1) = {"
E
k
k
k
a
a
a
a
a
a
a
a
a
a
a
a
a
a
a
a
a
k
k
k
k
k
k
k
k
E
"}
(18,1,1) = {"
E
k
k
k
a
a
a
a
a
a
a
a
a
a
a
a
a
a
a
p
a
k
k
k
k
k
k
k
k
E
"}
(19,1,1) = {"
E
k
k
k
a
a
a
a
a
a
a
a
a
a
a
a
a
a
a
a
a
k
k
k
k
k
k
k
k
E
"}
(20,1,1) = {"
E
k
k
k
k
a
a
a
a
a
a
a
a
a
a
a
a
a
a
a
a
a
k
k
k
k
k
k
k
E
"}
(21,1,1) = {"
E
k
k
k
k
a
a
a
a
a
a
a
a
a
a
a
a
a
a
a
a
a
k
k
k
k
k
k
k
E
"}
(22,1,1) = {"
E
k
k
k
k
a
a
a
p
a
a
a
a
a
a
a
a
a
a
a
a
a
a
k
k
k
k
k
k
E
"}
(23,1,1) = {"
E
k
k
k
k
a
a
a
a
a
a
a
a
B
a
a
a
a
a
a
a
a
a
a
k
k
k
k
k
E
"}
(24,1,1) = {"
E
k
k
k
k
a
a
a
a
a
a
a
a
a
a
a
a
a
a
a
a
a
a
a
k
k
k
k
k
E
"}
(25,1,1) = {"
E
k
k
k
k
a
a
a
a
a
a
a
a
a
a
a
a
a
a
a
a
a
a
a
k
k
k
k
k
E
"}
(26,1,1) = {"
E
k
k
k
k
a
a
a
a
a
a
a
a
a
a
a
a
a
a
a
a
a
a
a
k
k
k
k
k
E
"}
(27,1,1) = {"
E
k
k
k
k
a
a
a
a
a
a
a
a
a
a
a
a
a
a
a
a
a
a
k
k
k
k
k
k
E
"}
(28,1,1) = {"
E
k
k
k
k
a
a
a
a
a
a
a
a
a
a
a
a
a
a
a
a
a
a
k
k
k
k
k
k
E
"}
(29,1,1) = {"
E
k
k
k
k
a
a
a
a
a
a
a
a
a
a
a
a
a
a
a
a
a
a
k
k
k
k
k
k
E
"}
(30,1,1) = {"
E
k
k
k
k
a
a
a
a
a
a
a
a
B
a
a
a
a
a
a
a
a
a
k
k
k
k
k
k
E
"}
(31,1,1) = {"
E
k
k
k
k
a
a
a
p
a
a
a
a
a
a
a
a
a
a
a
a
a
a
k
k
k
k
k
k
E
"}
(32,1,1) = {"
E
k
k
k
k
a
a
a
a
a
a
a
a
a
a
a
a
a
a
a
a
a
k
k
k
k
k
k
k
E
"}
(33,1,1) = {"
E
k
k
k
k
a
a
a
a
a
a
a
a
a
a
a
a
p
a
a
a
a
k
k
k
k
k
k
k
E
"}
(34,1,1) = {"
E
k
k
k
k
k
a
a
a
a
a
p
a
a
a
a
a
a
a
a
a
k
k
k
k
k
k
k
k
E
"}
(35,1,1) = {"
E
k
k
k
k
k
a
a
a
a
a
a
a
q
a
a
a
a
a
a
k
k
k
k
k
k
k
k
k
E
"}
(36,1,1) = {"
E
k
k
k
k
k
a
a
a
a
a
a
a
a
a
a
a
a
a
a
k
k
k
k
k
k
k
k
k
E
"}
(37,1,1) = {"
E
k
k
k
k
k
a
a
a
a
a
a
a
B
a
a
a
a
a
k
k
k
k
k
k
k
k
k
k
E
"}
(38,1,1) = {"
E
k
k
k
k
k
a
a
a
a
a
a
a
a
a
a
a
a
a
a
k
k
k
k
k
k
k
k
k
E
"}
(39,1,1) = {"
E
k
k
k
k
a
a
a
a
a
a
a
a
a
a
a
a
a
a
a
a
k
k
k
k
k
k
k
k
E
"}
(40,1,1) = {"
E
k
k
k
a
a
a
a
a
a
a
H
a
a
a
a
a
a
a
a
a
a
k
k
k
k
k
k
k
E
"}
(41,1,1) = {"
E
k
k
k
a
a
a
a
a
a
a
a
a
a
a
a
a
a
a
a
a
a
a
k
k
k
k
k
k
E
"}
(42,1,1) = {"
E
k
k
k
a
a
a
a
a
a
a
a
a
a
a
a
a
a
a
a
a
a
a
a
k
k
k
k
k
E
"}
(43,1,1) = {"
E
k
k
k
a
a
a
a
a
a
a
a
a
a
a
k
k
a
a
a
a
a
a
a
k
k
k
k
k
E
"}
(44,1,1) = {"
E
k
k
k
a
a
a
a
k
k
a
a
a
B
a
a
k
k
a
a
a
a
a
a
a
k
k
k
k
E
"}
(45,1,1) = {"
E
k
k
k
a
a
a
a
k
a
a
a
a
a
a
a
a
k
k
a
a
a
a
a
a
k
k
k
k
E
"}
(46,1,1) = {"
E
k
k
a
a
a
a
k
k
a
a
a
a
p
a
a
a
a
k
a
a
a
a
a
a
k
k
k
k
E
"}
(47,1,1) = {"
E
k
k
a
a
a
a
k
a
a
H
a
a
a
a
a
a
a
a
H
a
a
a
a
a
a
k
k
k
E
"}
(48,1,1) = {"
E
k
k
a
a
a
a
k
a
U
a
a
h
U
p
K
h
a
a
a
U
a
a
a
a
a
k
k
k
E
"}
(49,1,1) = {"
E
k
k
a
a
a
a
k
a
a
a
Y
a
a
a
a
a
Y
a
a
a
a
a
a
a
a
k
k
k
E
"}
(50,1,1) = {"
E
k
k
a
a
a
a
k
a
a
a
a
a
a
Y
a
U
a
a
a
a
a
a
a
a
a
k
k
k
E
"}
(51,1,1) = {"
E
k
k
a
a
a
a
a
a
a
a
a
K
a
U
a
Y
a
S
a
a
a
a
a
a
a
k
k
k
E
"}
(52,1,1) = {"
E
k
k
a
a
a
a
a
a
p
a
U
a
a
h
a
a
a
a
a
a
a
a
H
a
a
k
k
k
E
"}
(53,1,1) = {"
E
k
k
k
a
a
a
a
a
a
a
a
a
a
a
Y
a
a
U
a
a
a
a
a
a
a
k
k
k
E
"}
(54,1,1) = {"
E
k
k
k
a
a
H
a
a
a
a
a
a
a
a
a
a
a
a
a
a
k
a
a
a
a
k
k
k
E
"}
(55,1,1) = {"
E
k
k
k
a
a
a
a
k
a
a
a
a
a
a
a
a
a
a
k
k
k
a
a
a
a
k
k
k
E
"}
(56,1,1) = {"
E
k
k
k
a
a
a
a
k
k
a
H
a
a
a
a
p
a
k
k
a
a
a
a
a
a
k
k
k
E
"}
(57,1,1) = {"
E
k
k
k
a
a
a
a
a
k
a
a
a
a
a
a
a
a
k
a
a
a
a
a
a
k
k
k
k
E
"}
(58,1,1) = {"
E
k
k
k
k
a
a
a
a
k
k
a
a
B
a
a
a
a
a
a
a
a
a
a
a
k
k
k
k
E
"}
(59,1,1) = {"
E
k
k
k
k
a
a
a
a
a
a
a
a
a
a
a
a
a
a
a
a
a
a
a
a
k
k
k
k
E
"}
(60,1,1) = {"
E
k
k
k
k
k
a
a
a
a
a
a
a
a
a
a
a
a
a
a
a
a
a
a
a
k
k
k
k
E
"}
(61,1,1) = {"
E
k
k
k
k
k
a
H
a
a
a
a
a
a
a
a
a
p
a
a
a
a
a
a
k
k
k
k
k
E
"}
(62,1,1) = {"
E
k
k
k
k
k
a
a
a
a
a
a
a
a
a
a
a
a
H
a
a
a
a
a
k
k
k
k
k
E
"}
(63,1,1) = {"
E
k
k
k
k
k
a
a
a
a
a
a
a
a
a
a
a
a
a
a
a
a
a
k
k
k
k
k
k
E
"}
(64,1,1) = {"
E
k
k
k
k
k
k
a
a
a
a
a
a
a
a
a
a
a
a
a
a
a
a
k
k
k
k
k
k
E
"}
(65,1,1) = {"
E
k
k
k
k
k
k
a
a
a
a
a
a
B
a
a
a
a
a
a
a
a
k
k
k
k
k
k
k
E
"}
(66,1,1) = {"
E
k
k
k
k
k
k
a
a
a
a
a
a
a
a
a
a
a
a
a
a
k
k
k
k
k
k
k
k
E
"}
(67,1,1) = {"
E
k
k
k
k
k
k
a
a
a
a
a
a
a
a
a
a
a
a
a
k
k
k
k
k
k
k
k
k
E
"}
(68,1,1) = {"
E
k
k
k
k
k
a
a
a
a
a
a
a
a
a
a
a
a
a
k
k
k
k
k
k
k
k
k
k
E
"}
(69,1,1) = {"
E
k
k
k
k
k
a
a
a
a
a
a
a
a
a
a
a
a
a
k
k
k
k
k
k
k
k
k
k
E
"}
(70,1,1) = {"
E
k
k
k
k
a
a
a
a
a
a
a
a
a
a
a
a
a
a
k
k
k
k
k
k
k
k
k
k
E
"}
(71,1,1) = {"
E
k
k
k
a
a
a
a
a
a
a
a
a
a
a
a
a
a
a
k
k
k
k
k
k
k
k
k
k
E
"}
(72,1,1) = {"
E
k
k
a
a
a
a
a
a
p
a
a
a
B
a
a
a
a
a
k
k
k
k
k
k
k
k
k
k
E
"}
(73,1,1) = {"
E
k
k
a
p
a
a
a
a
a
a
a
a
a
a
a
a
a
a
a
k
k
k
k
k
k
k
k
k
E
"}
(74,1,1) = {"
E
k
a
a
a
a
a
a
a
a
a
a
a
a
a
a
a
a
a
a
k
k
k
k
k
k
k
k
k
E
"}
(75,1,1) = {"
E
k
a
a
a
a
a
a
a
a
a
a
a
a
a
a
a
a
a
a
k
k
k
k
k
k
k
k
k
E
"}
(76,1,1) = {"
E
k
a
a
a
a
a
a
a
a
a
a
a
a
a
a
a
a
a
a
k
k
k
k
k
k
k
k
k
E
"}
(77,1,1) = {"
E
k
a
a
a
p
a
a
a
p
a
a
a
a
a
a
a
a
a
a
k
k
k
k
k
k
k
k
k
E
"}
(78,1,1) = {"
E
k
k
a
a
a
a
a
a
a
a
a
a
a
a
a
a
a
a
a
k
k
k
k
k
k
k
k
k
E
"}
(79,1,1) = {"
E
k
k
a
a
a
a
a
a
a
a
a
a
B
a
a
a
a
a
a
k
k
k
k
k
k
k
k
k
E
"}
(80,1,1) = {"
E
k
k
a
a
a
a
a
a
a
a
a
a
a
a
a
a
p
a
a
k
k
k
k
k
k
k
k
k
E
"}
(81,1,1) = {"
E
k
k
a
a
a
a
a
a
a
a
a
a
a
a
a
a
a
a
a
k
k
k
k
k
k
k
k
k
E
"}
(82,1,1) = {"
E
k
k
a
a
a
a
a
a
a
a
a
a
a
a
a
a
a
a
a
k
k
k
k
k
k
k
k
k
E
"}
(83,1,1) = {"
E
k
k
a
a
a
a
p
a
a
a
a
a
a
a
a
a
a
a
a
k
k
k
k
k
k
k
k
k
E
"}
(84,1,1) = {"
E
k
k
a
a
a
a
a
a
a
a
a
a
a
a
a
a
a
a
a
k
k
k
k
k
k
k
k
k
E
"}
(85,1,1) = {"
E
k
k
k
a
a
a
a
a
a
a
a
a
a
a
a
a
a
a
a
k
k
k
k
k
k
k
k
k
E
"}
(86,1,1) = {"
E
k
k
k
a
a
a
a
a
a
a
a
a
B
a
a
a
p
p
a
a
k
k
k
k
k
k
k
k
E
"}
(87,1,1) = {"
E
k
k
k
a
a
a
a
a
a
a
a
a
a
a
a
a
a
a
a
a
k
k
k
k
k
k
k
k
E
"}
(88,1,1) = {"
E
k
k
k
a
a
a
a
a
a
a
a
a
a
a
a
a
a
a
a
a
k
k
k
k
k
k
k
k
E
"}
(89,1,1) = {"
E
k
k
k
a
a
a
a
a
a
a
a
a
a
a
a
a
a
a
a
a
k
k
k
k
k
k
k
k
E
"}
(90,1,1) = {"
E
k
k
k
a
a
a
a
a
a
a
a
a
a
a
a
a
a
a
a
a
k
k
k
k
k
k
k
k
E
"}
(91,1,1) = {"
E
k
k
k
a
a
a
a
a
a
a
a
a
a
a
a
a
a
a
a
a
k
k
k
k
k
k
k
k
E
"}
(92,1,1) = {"
E
k
k
k
a
a
a
a
p
a
a
a
a
a
a
a
a
a
a
a
a
k
k
k
k
k
k
k
k
E
"}
(93,1,1) = {"
E
k
k
k
a
a
a
a
a
a
a
a
a
B
a
a
a
a
a
a
a
k
k
k
k
k
k
k
k
E
"}
(94,1,1) = {"
E
k
k
k
a
a
a
a
a
a
a
a
a
a
a
a
a
a
a
a
a
a
k
k
k
k
k
k
k
E
"}
(95,1,1) = {"
E
k
k
k
a
a
a
a
a
a
a
a
a
a
a
a
a
a
a
a
a
a
k
k
k
k
k
k
k
E
"}
(96,1,1) = {"
E
k
k
k
a
a
a
a
a
a
a
a
a
a
a
a
a
a
a
a
a
a
k
k
k
k
k
k
k
E
"}
(97,1,1) = {"
E
k
k
k
a
a
a
a
a
a
a
a
a
a
a
a
a
a
a
a
a
a
k
k
k
k
k
k
k
E
"}
(98,1,1) = {"
E
k
k
k
a
a
a
a
a
a
a
a
a
a
a
a
a
a
a
a
a
a
k
k
k
k
k
k
k
E
"}
(99,1,1) = {"
E
k
k
k
a
a
a
a
a
a
a
a
a
a
a
a
a
a
a
a
a
a
k
k
k
k
k
k
k
E
"}
(100,1,1) = {"
E
k
k
k
a
a
a
a
a
a
a
a
a
B
a
a
a
a
a
a
a
a
k
k
k
k
k
k
k
E
"}
(101,1,1) = {"
E
k
k
k
a
a
a
a
a
a
a
a
a
a
a
a
a
a
a
p
a
a
k
k
k
k
k
k
k
E
"}
(102,1,1) = {"
E
k
k
k
k
a
a
a
a
a
a
a
a
a
a
a
a
a
a
a
a
a
k
k
k
k
k
k
k
E
"}
(103,1,1) = {"
E
k
k
k
k
a
a
a
a
a
a
a
a
a
a
a
a
a
a
a
a
a
k
k
k
k
k
k
k
E
"}
(104,1,1) = {"
E
k
k
k
k
a
a
a
p
a
a
a
a
a
a
a
a
a
a
a
a
a
a
k
k
k
k
k
k
E
"}
(105,1,1) = {"
E
k
k
k
k
a
a
a
a
a
a
a
a
a
a
a
a
a
a
a
a
a
a
k
k
k
k
k
k
E
"}
(106,1,1) = {"
E
k
k
k
k
a
a
a
a
a
a
a
a
a
a
a
a
a
a
a
a
a
a
k
k
k
k
k
k
E
"}
(107,1,1) = {"
E
k
k
k
k
a
a
a
a
a
a
a
a
B
a
a
a
a
a
a
a
a
a
k
k
k
k
k
k
E
"}
(108,1,1) = {"
E
k
k
k
k
a
a
a
a
a
a
a
a
a
a
a
a
a
a
a
a
a
a
k
k
k
k
k
k
E
"}
(109,1,1) = {"
E
k
k
k
k
a
a
a
a
a
a
a
a
a
a
a
a
a
a
a
a
a
a
k
k
k
k
k
k
E
"}
(110,1,1) = {"
E
k
k
k
k
k
a
a
a
a
a
a
a
a
a
a
a
a
a
a
a
a
a
k
k
k
k
k
k
E
"}
(111,1,1) = {"
E
k
k
k
k
k
a
a
a
a
a
a
a
a
a
a
a
a
a
a
a
a
a
k
k
k
k
k
k
E
"}
(112,1,1) = {"
E
k
k
k
k
k
a
a
a
a
a
a
a
a
a
a
a
p
a
a
a
a
a
k
k
k
k
k
k
E
"}
(113,1,1) = {"
E
k
k
k
k
k
a
a
p
a
a
a
a
a
a
a
a
a
a
a
a
a
a
a
k
k
k
k
k
E
"}
(114,1,1) = {"
E
k
k
k
k
k
a
a
a
a
a
a
a
B
a
a
a
a
a
a
a
a
a
a
k
k
k
k
k
E
"}
(115,1,1) = {"
E
k
k
k
k
k
a
a
a
a
a
a
a
a
a
a
a
a
a
a
a
a
a
a
k
k
k
k
k
E
"}
(116,1,1) = {"
E
k
k
k
k
k
a
a
a
a
a
a
a
a
a
a
a
a
a
a
a
a
a
a
k
k
k
k
k
E
"}
(117,1,1) = {"
E
k
k
k
k
k
k
a
a
a
a
a
p
a
a
a
a
a
a
a
a
a
a
a
a
k
k
k
k
E
"}
(118,1,1) = {"
E
k
k
k
k
k
k
a
a
a
a
a
a
a
a
a
a
a
a
a
a
a
a
a
a
a
k
k
k
E
"}
(119,1,1) = {"
E
k
k
k
k
k
k
a
a
a
a
a
a
a
a
a
a
a
a
a
a
p
a
a
a
a
k
k
k
E
"}
(120,1,1) = {"
E
E
E
E
E
E
E
E
E
E
E
E
E
E
E
E
E
E
E
E
E
E
E
E
E
E
E
E
E
E
"}

(1,1,2) = {"
E
E
E
E
E
E
E
E
E
E
E
E
E
E
E
E
E
E
E
E
E
E
E
E
E
E
E
E
E
u
"}
(2,1,2) = {"
E
k
a
f
f
f
f
f
f
o
x
V
V
m
V
V
X
a
a
k
k
k
k
k
k
k
k
k
k
A
"}
(3,1,2) = {"
E
k
a
f
f
f
f
f
f
o
z
d
d
Q
d
w
Z
f
a
k
k
k
k
k
k
k
k
k
k
E
"}
(4,1,2) = {"
E
k
a
f
f
f
f
f
o
N
z
d
d
d
d
d
Z
f
a
k
k
k
k
k
k
k
k
k
k
E
"}
(5,1,2) = {"
E
k
a
f
f
f
f
f
o
f
z
I
I
d
d
d
Z
f
a
a
k
k
k
k
k
k
k
k
k
E
"}
(6,1,2) = {"
E
k
a
a
f
f
f
f
o
s
z
I
i
d
d
d
Z
f
f
a
k
k
k
k
k
k
k
k
k
E
"}
(7,1,2) = {"
E
k
k
a
f
f
f
f
f
o
z
d
d
d
I
d
Z
f
f
a
k
k
k
k
k
k
k
k
k
E
"}
(8,1,2) = {"
E
k
k
a
f
f
f
f
f
o
z
d
d
I
I
d
Z
f
f
a
a
k
k
k
k
k
k
k
k
E
"}
(9,1,2) = {"
E
k
k
a
f
f
f
f
f
o
z
d
d
Q
d
d
Z
f
f
f
a
k
k
k
k
k
k
k
k
E
"}
(10,1,2) = {"
E
k
k
a
f
f
f
f
f
o
z
I
d
Q
I
I
Z
f
f
f
a
k
k
k
k
k
k
k
k
E
"}
(11,1,2) = {"
E
k
k
a
f
f
f
f
f
o
z
I
d
d
I
I
Z
f
f
f
a
a
k
k
k
k
k
k
k
E
"}
(12,1,2) = {"
E
k
k
a
f
f
f
f
f
o
z
d
d
d
d
d
Z
f
f
f
a
a
k
k
k
k
k
k
k
E
"}
(13,1,2) = {"
E
k
k
a
f
f
f
f
f
o
z
d
d
I
d
d
Z
f
f
f
f
a
k
k
k
k
k
k
k
E
"}
(14,1,2) = {"
E
k
k
a
f
f
f
f
f
o
z
d
d
d
d
d
Z
f
f
f
f
a
k
k
k
k
k
k
k
E
"}
(15,1,2) = {"
E
k
k
a
f
f
f
f
f
o
z
d
d
Q
I
d
Z
f
f
f
f
a
k
k
k
k
k
k
k
E
"}
(16,1,2) = {"
E
k
k
a
f
f
f
f
f
o
z
I
d
Q
d
d
Z
f
f
f
f
a
a
k
k
k
k
k
k
E
"}
(17,1,2) = {"
E
k
k
a
f
f
f
f
f
o
z
d
d
Q
d
d
Z
f
f
f
f
a
a
k
k
k
k
k
k
E
"}
(18,1,2) = {"
E
k
k
a
f
f
f
f
f
o
z
I
d
d
d
d
Z
f
f
f
f
a
a
k
k
k
k
k
k
E
"}
(19,1,2) = {"
E
k
k
a
f
f
f
f
f
o
z
d
d
d
d
I
Z
f
f
f
f
a
a
k
k
k
k
k
k
E
"}
(20,1,2) = {"
E
k
k
a
a
f
f
f
f
o
z
d
I
I
d
I
Z
f
f
f
f
f
a
k
k
k
k
k
k
E
"}
(21,1,2) = {"
E
k
k
k
a
f
f
f
f
o
z
d
d
d
d
I
Z
f
f
f
f
f
a
a
k
k
k
k
k
E
"}
(22,1,2) = {"
E
k
k
k
a
f
f
f
f
o
I
d
d
Q
d
I
Z
f
f
f
f
f
f
a
a
k
k
k
k
E
"}
(23,1,2) = {"
E
k
k
k
a
f
f
f
f
o
I
I
d
Q
d
d
Z
f
f
f
f
f
f
f
a
k
k
k
k
E
"}
(24,1,2) = {"
E
k
k
k
a
f
f
f
f
o
z
I
d
Q
d
d
Z
f
f
f
f
f
f
f
a
k
k
k
k
E
"}
(25,1,2) = {"
E
k
k
k
a
f
f
f
f
o
z
d
d
d
d
I
o
f
f
f
f
f
f
f
a
k
k
k
k
E
"}
(26,1,2) = {"
E
k
k
k
a
f
f
f
f
o
I
I
I
I
d
d
Z
f
f
f
f
f
f
f
a
k
k
k
k
E
"}
(27,1,2) = {"
E
k
k
k
a
f
f
f
f
o
I
I
d
d
d
d
Z
f
f
f
f
f
f
a
a
k
k
k
k
E
"}
(28,1,2) = {"
E
k
k
k
a
f
f
f
f
o
z
d
d
d
d
d
Z
f
f
f
f
f
f
a
k
k
k
k
k
E
"}
(29,1,2) = {"
E
k
k
k
a
f
f
f
f
o
z
d
d
Q
d
d
Z
f
f
f
f
f
f
a
k
k
k
k
k
E
"}
(30,1,2) = {"
E
k
k
k
a
f
f
f
f
o
z
d
d
Q
I
d
Z
f
f
f
f
f
f
a
k
k
k
k
k
E
"}
(31,1,2) = {"
E
k
k
k
a
f
f
f
f
o
z
d
d
Q
I
d
Z
f
f
f
f
f
f
a
k
k
k
k
k
E
"}
(32,1,2) = {"
E
k
k
k
a
f
f
f
f
o
z
I
d
Q
d
d
Z
f
f
f
f
f
a
a
k
k
k
k
k
E
"}
(33,1,2) = {"
E
k
k
k
a
f
f
f
f
o
z
I
I
I
d
d
Z
f
f
f
f
f
a
a
k
k
k
k
k
E
"}
(34,1,2) = {"
E
k
k
k
a
a
f
f
f
o
z
d
I
I
d
d
Z
f
f
f
f
a
a
k
k
k
k
k
k
E
"}
(35,1,2) = {"
E
k
k
k
k
a
f
f
f
o
z
d
d
I
I
d
Z
f
f
f
a
a
a
k
k
k
k
k
k
E
"}
(36,1,2) = {"
E
k
k
k
k
a
f
f
f
o
z
d
d
Q
d
d
Z
f
f
f
a
a
k
k
k
k
k
k
k
E
"}
(37,1,2) = {"
E
k
k
k
k
a
f
f
f
o
z
d
d
Q
d
d
Z
f
f
a
a
k
k
k
k
k
k
k
k
E
"}
(38,1,2) = {"
E
k
k
k
a
a
f
f
f
o
z
I
d
Q
d
d
Z
f
f
f
a
a
k
k
k
k
k
k
k
E
"}
(39,1,2) = {"
E
k
k
a
a
f
f
f
f
o
z
d
d
Q
d
I
Z
f
f
f
f
a
a
k
k
k
k
k
k
E
"}
(40,1,2) = {"
E
k
k
a
f
f
f
f
f
o
z
d
d
Q
d
d
Z
f
f
f
f
f
a
a
k
k
k
k
k
E
"}
(41,1,2) = {"
E
k
k
a
f
f
f
f
f
o
z
d
d
Q
d
d
Z
f
f
f
f
f
f
a
a
k
k
k
k
E
"}
(42,1,2) = {"
E
k
k
a
f
f
f
f
f
o
z
d
I
Q
d
d
Z
f
f
f
f
f
f
f
a
k
k
k
k
E
"}
(43,1,2) = {"
E
k
k
a
f
f
f
f
f
o
I
d
d
Q
d
d
Z
f
f
f
f
f
f
f
a
a
k
k
k
E
"}
(44,1,2) = {"
E
k
k
a
f
f
f
f
f
o
z
d
d
Q
O
e
Z
f
f
f
f
f
f
f
f
a
k
k
k
E
"}
(45,1,2) = {"
E
k
a
a
f
f
f
f
f
o
z
O
O
Q
d
O
Z
s
f
f
f
f
f
f
f
a
k
k
k
E
"}
(46,1,2) = {"
E
k
a
f
f
f
f
f
f
o
P
O
g
l
O
I
I
f
f
f
f
f
f
f
f
a
a
k
k
E
"}
(47,1,2) = {"
E
N
N
D
D
N
N
I
s
b
I
I
F
O
I
I
f
f
f
f
f
f
f
f
f
f
a
k
k
E
"}
(48,1,2) = {"
E
d
d
d
d
d
d
I
r
f
f
I
f
I
I
f
f
f
f
f
f
f
f
f
f
f
a
k
k
E
"}
(49,1,2) = {"
E
d
d
d
d
d
d
d
I
f
f
I
f
I
f
f
f
f
f
o
f
f
f
f
f
f
a
k
k
E
"}
(50,1,2) = {"
E
Q
Q
Q
Q
I
d
d
f
f
f
I
f
I
f
f
f
f
f
o
f
f
f
f
f
f
a
k
k
E
"}
(51,1,2) = {"
E
d
d
I
I
I
d
I
I
y
f
I
f
I
I
I
I
f
o
v
f
f
f
f
f
f
a
k
k
E
"}
(52,1,2) = {"
E
d
d
I
d
d
d
d
I
o
f
I
I
I
I
g
Z
v
v
f
f
f
f
f
f
f
a
k
k
E
"}
(53,1,2) = {"
E
W
W
W
W
W
W
I
I
o
f
I
I
d
d
O
Z
f
f
f
f
f
f
f
f
f
a
k
k
E
"}
(54,1,2) = {"
E
k
k
a
f
f
f
f
f
o
f
f
d
O
T
d
Z
f
f
f
f
f
f
f
f
f
a
k
k
E
"}
(55,1,2) = {"
E
k
k
a
f
f
f
f
f
o
P
d
O
c
O
d
Z
f
f
f
f
f
f
f
f
f
a
k
k
E
"}
(56,1,2) = {"
E
k
k
a
f
f
f
f
f
o
P
O
O
d
d
d
Z
f
f
f
f
f
f
f
f
a
a
k
k
E
"}
(57,1,2) = {"
E
k
k
a
f
f
f
f
f
o
z
O
d
Q
d
d
Z
f
f
f
f
f
f
f
f
a
k
k
k
E
"}
(58,1,2) = {"
E
k
k
a
a
f
f
f
f
o
z
O
I
Q
d
d
M
f
f
f
f
f
f
f
f
a
k
k
k
E
"}
(59,1,2) = {"
E
k
k
k
a
f
f
f
f
o
z
d
d
Q
d
I
M
f
f
f
f
f
f
f
f
a
k
k
k
E
"}
(60,1,2) = {"
E
k
k
k
a
a
f
f
f
o
z
I
d
Q
I
I
Z
f
f
f
f
f
f
f
f
a
k
k
k
E
"}
(61,1,2) = {"
E
k
k
k
k
a
f
f
f
o
z
I
d
Q
d
d
Z
f
f
f
f
f
f
f
a
a
k
k
k
E
"}
(62,1,2) = {"
E
k
k
k
k
a
f
f
f
o
z
I
I
I
d
d
Z
f
f
f
f
f
f
f
a
k
k
k
k
E
"}
(63,1,2) = {"
E
k
k
k
k
a
a
f
f
o
I
I
I
I
I
d
Z
f
f
f
f
f
f
a
a
k
k
k
k
E
"}
(64,1,2) = {"
E
k
k
k
k
k
a
f
f
o
z
d
d
I
I
d
Z
f
f
f
f
f
a
a
k
k
k
k
k
E
"}
(65,1,2) = {"
E
k
k
k
k
k
a
f
f
o
z
d
d
Q
I
d
Z
f
f
f
f
f
a
k
k
k
k
k
k
E
"}
(66,1,2) = {"
E
k
k
k
k
k
a
f
f
o
z
d
d
Q
d
d
Z
f
f
f
f
a
a
k
k
k
k
k
k
E
"}
(67,1,2) = {"
E
k
k
k
k
k
a
f
f
o
z
d
d
Q
d
d
Z
f
f
f
a
a
k
k
k
k
k
k
k
E
"}
(68,1,2) = {"
E
k
k
k
k
k
a
f
f
o
z
d
d
Q
d
d
Z
f
f
a
a
k
k
k
k
k
k
k
k
E
"}
(69,1,2) = {"
E
k
k
k
a
a
a
f
f
o
z
d
d
Q
d
d
Z
f
f
a
k
k
k
k
k
k
k
k
k
E
"}
(70,1,2) = {"
E
k
k
a
a
f
f
f
f
o
z
d
d
Q
I
d
Z
f
f
a
k
k
k
k
k
k
k
k
k
E
"}
(71,1,2) = {"
E
k
a
a
f
f
f
f
f
o
z
I
d
Q
d
d
Z
f
f
a
k
k
k
k
k
k
k
k
k
E
"}
(72,1,2) = {"
E
k
a
f
f
f
f
f
f
o
z
d
d
Q
d
d
Z
f
f
a
k
k
k
k
k
k
k
k
k
E
"}
(73,1,2) = {"
E
a
a
f
f
f
f
f
f
o
z
d
d
Q
d
d
Z
f
f
a
a
k
k
k
k
k
k
k
k
E
"}
(74,1,2) = {"
E
a
a
f
f
f
f
f
f
o
z
I
d
d
I
I
Z
f
f
f
a
k
k
k
k
k
k
k
k
E
"}
(75,1,2) = {"
E
a
f
f
f
f
f
f
f
o
z
d
d
I
I
I
Z
f
f
f
a
k
k
k
k
k
k
k
k
E
"}
(76,1,2) = {"
E
a
f
f
f
f
f
f
f
o
z
d
d
d
d
I
Z
f
f
f
a
k
k
k
k
k
k
k
k
E
"}
(77,1,2) = {"
E
a
f
f
f
f
f
f
f
o
z
d
d
I
d
d
M
f
f
f
a
k
k
k
k
k
k
k
k
E
"}
(78,1,2) = {"
E
a
a
f
f
f
f
f
f
o
z
d
d
Q
d
d
Z
f
f
f
a
k
k
k
k
k
k
k
k
E
"}
(79,1,2) = {"
E
k
a
f
f
f
f
f
f
o
z
d
d
Q
d
d
Z
f
f
f
a
k
k
k
k
k
k
k
k
E
"}
(80,1,2) = {"
E
k
a
f
f
f
f
f
f
o
z
I
d
Q
d
d
Z
f
f
f
a
k
k
k
k
k
k
k
k
E
"}
(81,1,2) = {"
E
k
a
f
f
f
f
f
f
o
z
d
d
d
d
d
Z
f
f
f
a
k
k
k
k
k
k
k
k
E
"}
(82,1,2) = {"
E
k
a
f
f
f
f
f
f
o
z
d
I
I
I
d
Z
f
f
f
a
k
k
k
k
k
k
k
k
E
"}
(83,1,2) = {"
E
k
a
f
f
f
f
f
f
o
z
d
I
I
d
d
Z
f
f
f
a
k
k
k
k
k
k
k
k
E
"}
(84,1,2) = {"
E
k
a
a
f
f
f
f
f
o
z
d
d
d
d
I
Z
f
f
f
a
k
k
k
k
k
k
k
k
E
"}
(85,1,2) = {"
E
k
k
a
f
f
f
f
f
o
z
I
d
Q
d
d
Z
f
f
f
a
k
k
k
k
k
k
k
k
E
"}
(86,1,2) = {"
E
k
k
a
f
f
f
f
f
o
z
d
d
Q
d
d
Z
f
f
f
a
a
k
k
k
k
k
k
k
E
"}
(87,1,2) = {"
E
k
k
a
f
f
f
f
f
o
z
d
d
Q
d
d
Z
f
f
f
f
a
k
k
k
k
k
k
k
E
"}
(88,1,2) = {"
E
k
k
a
f
f
f
f
f
o
z
d
d
d
I
d
Z
f
f
f
f
a
k
k
k
k
k
k
k
E
"}
(89,1,2) = {"
E
k
k
a
f
f
f
f
f
o
z
d
d
d
d
d
Z
f
f
f
f
a
k
k
k
k
k
k
k
E
"}
(90,1,2) = {"
E
k
k
a
f
f
f
f
f
o
z
d
I
d
d
d
Z
f
f
f
f
a
k
k
k
k
k
k
k
E
"}
(91,1,2) = {"
E
k
k
a
f
f
f
f
f
o
z
d
d
d
I
d
Z
f
f
f
f
a
k
k
k
k
k
k
k
E
"}
(92,1,2) = {"
E
k
k
a
f
f
f
f
f
o
z
d
d
Q
d
d
Z
f
f
f
f
a
k
k
k
k
k
k
k
E
"}
(93,1,2) = {"
E
k
k
a
f
f
f
f
f
o
z
d
d
Q
d
d
Z
f
f
f
f
a
a
k
k
k
k
k
k
E
"}
(94,1,2) = {"
E
k
k
a
f
f
f
f
f
o
z
d
d
Q
d
I
Z
f
f
f
f
f
a
k
k
k
k
k
k
E
"}
(95,1,2) = {"
E
k
k
a
f
f
f
f
f
o
z
I
d
d
d
d
Z
f
f
f
f
f
a
k
k
k
k
k
k
E
"}
(96,1,2) = {"
E
k
k
a
f
f
f
f
f
o
z
d
d
d
d
d
Z
f
f
f
f
f
a
k
k
k
k
k
k
E
"}
(97,1,2) = {"
E
k
k
a
f
f
f
f
f
o
z
d
d
d
d
d
Z
f
f
f
f
f
a
k
k
k
k
k
k
E
"}
(98,1,2) = {"
E
k
k
a
f
f
f
f
f
o
z
d
d
d
d
d
Z
f
f
f
f
f
a
k
k
k
k
k
k
E
"}
(99,1,2) = {"
E
k
k
a
f
f
f
f
f
o
z
d
d
I
d
d
Z
f
f
f
f
f
a
k
k
k
k
k
k
E
"}
(100,1,2) = {"
E
k
k
a
f
f
f
f
f
o
z
d
d
Q
d
I
Z
f
f
f
f
f
a
k
k
k
k
k
k
E
"}
(101,1,2) = {"
E
k
k
a
f
f
f
f
f
o
z
d
d
Q
d
d
Z
f
f
f
f
f
a
k
k
k
k
k
k
E
"}
(102,1,2) = {"
E
k
k
a
a
f
f
f
f
o
z
I
d
d
d
d
Z
f
f
f
f
f
a
k
k
k
k
k
k
E
"}
(103,1,2) = {"
E
k
k
k
a
f
f
f
f
o
z
d
d
I
d
d
Z
f
f
f
f
f
a
a
k
k
k
k
k
E
"}
(104,1,2) = {"
E
k
k
k
a
f
f
f
f
o
z
d
d
d
d
d
Z
f
f
f
f
f
f
a
k
k
k
k
k
E
"}
(105,1,2) = {"
E
k
k
k
a
f
f
f
f
o
z
d
d
d
d
I
Z
f
f
f
f
f
f
a
k
k
k
k
k
E
"}
(106,1,2) = {"
E
k
k
k
a
f
f
f
f
o
z
I
d
Q
d
d
Z
f
f
f
f
f
f
a
k
k
k
k
k
E
"}
(107,1,2) = {"
E
k
k
k
a
f
f
f
f
o
z
d
d
Q
d
d
Z
f
f
f
f
f
f
a
k
k
k
k
k
E
"}
(108,1,2) = {"
E
k
k
k
a
f
f
f
f
o
z
d
d
Q
d
d
Z
f
f
f
f
f
f
a
k
k
k
k
k
E
"}
(109,1,2) = {"
E
k
k
k
a
f
f
f
f
o
z
d
d
d
d
d
Z
f
f
f
f
f
f
a
k
k
k
k
k
E
"}
(110,1,2) = {"
E
k
k
k
a
a
f
f
f
o
z
I
d
d
d
d
Z
f
f
f
f
f
f
a
k
k
k
k
k
E
"}
(111,1,2) = {"
E
k
k
k
k
a
f
f
f
o
I
d
d
d
d
d
Z
f
f
f
f
f
f
a
k
k
k
k
k
E
"}
(112,1,2) = {"
E
k
k
k
k
a
f
f
f
o
I
d
d
d
d
d
Z
f
f
f
f
f
f
a
a
k
k
k
k
E
"}
(113,1,2) = {"
E
k
k
k
k
a
f
f
f
o
I
I
I
Q
d
d
Z
f
f
f
f
f
f
f
a
k
k
k
k
E
"}
(114,1,2) = {"
E
k
k
k
k
a
f
f
f
o
I
I
d
Q
d
d
Z
f
f
f
f
f
f
f
a
k
k
k
k
E
"}
(115,1,2) = {"
E
k
k
k
k
a
f
f
f
o
I
I
d
Q
d
d
M
f
f
f
f
f
f
f
a
k
k
k
k
E
"}
(116,1,2) = {"
E
k
k
k
k
a
f
f
f
o
z
d
d
d
d
d
Z
f
f
f
f
f
f
f
a
a
k
k
k
E
"}
(117,1,2) = {"
E
k
k
k
k
a
a
f
f
o
z
d
d
d
d
I
Z
f
f
f
f
f
f
f
f
a
a
k
k
E
"}
(118,1,2) = {"
E
k
k
k
k
k
a
f
f
o
z
d
d
d
d
I
M
f
f
f
f
f
f
f
f
f
a
k
k
E
"}
(119,1,2) = {"
E
k
k
k
k
k
a
f
f
o
C
R
R
j
R
L
G
f
f
f
f
f
f
f
f
f
a
k
k
E
"}
(120,1,2) = {"
E
E
E
E
E
E
E
E
E
E
E
E
E
E
E
E
E
E
E
E
E
E
E
E
E
E
E
E
E
E
"}
