//MAP CONVERTED BY dmm2tgm.py THIS HEADER COMMENT PREVENTS RECONVERSION, DO NOT REMOVE
"b" = (
/obj/structure/table/steel,
/obj/item/co2filter/large,
/obj/item/co2filter/large,
/obj/item/co2filter/large,
/obj/item/co2filter/large,
/turf/simulated/floor/reinforced/void,
/area/shuttle)
"c" = (
/obj/machinery/portable_atmospherics/canister/oxygen,
/turf/simulated/floor/reinforced/void,
/area/shuttle)
"d" = (
/obj/machinery/light/spot{
	pixel_x = -20
	},
/turf/simulated/floor/reinforced/void,
/area/shuttle)
"e" = (
/obj/machinery/modernsuit_storage,
/turf/simulated/floor/reinforced/void,
/area/shuttle)
"f" = (
/obj/structure/ore_box,
/obj/structure/railing/mapped,
/turf/simulated/floor/reinforced/void,
/area/shuttle)
"g" = (
/obj/structure/table/steel,
/obj/item/pickaxe/drill,
/turf/simulated/floor/reinforced/void,
/area/shuttle)
"n" = (
/obj/structure/bed/chair/comfy/vehicle/cts{
	dir = 1;
	icon_state = "shuttle_chair_preview";
	buckle_pixel_shift = list("x"=-7,"y"=-13,"z"=0);
	pixel_x = -7;
	pixel_y = -13
	},
/turf/simulated/floor/reinforced/void,
/area/shuttle)
"p" = (
/obj/structure/cart{
	dir = 8
	},
/turf/simulated/floor/reinforced/void,
/area/shuttle)
"r" = (
/obj/structure/table/steel,
/obj/structure/railing/mapped,
/obj/item/gps,
/obj/item/stack/tape_roll/suit_sealing,
/obj/item/stack/tape_roll/suit_sealing,
/turf/simulated/floor/reinforced/void,
/area/shuttle)
"s" = (
/obj/structure/bed/chair/shuttle/black{
	dir = 8
	},
/obj/structure/railing/mapped,
/turf/simulated/floor/reinforced/void,
/area/shuttle)
"y" = (
/obj/structure/bed/chair/shuttle/black{
	dir = 8
	},
/turf/simulated/floor/reinforced/void,
/area/shuttle)
"B" = (
/obj/structure/table/steel,
/obj/machinery/cell_charger,
/turf/simulated/floor/reinforced/void,
/area/shuttle)
"E" = (
/obj/effect/invisible_barrier/opaque,
/turf/simulated/floor/reinforced/void/nopass,
/area/shuttle)
"I" = (
/obj/structure/bed/roller/hydraulic,
/turf/simulated/floor/reinforced/void,
/area/shuttle)
"M" = (
/obj/structure/table/steel,
/obj/item/storage/toolbox/mechanical,
/obj/item/stack/cable_coil,
/turf/simulated/floor/reinforced/void,
/area/shuttle)
"N" = (
/obj/structure/table/steel,
/obj/machinery/recharger,
/turf/simulated/floor/reinforced/void,
/area/shuttle)
"P" = (
/obj/effect/cts_floor,
/obj/effect/invisible_barrier/opaque,
/obj/effect/cts_ceiling,
/turf/simulated/floor/reinforced/void/nopass,
/area/shuttle)
"Q" = (
/obj/machinery/light/spot{
	pixel_x = 20
	},
/turf/simulated/floor/reinforced/void,
/area/shuttle)
"T" = (
/obj/effect/interior_entrypoint/vehicle/lander{
	pixel_y = 0;
	pixel_x = -32
	},
/turf/simulated/floor/reinforced/void,
/area/shuttle)
"U" = (
/turf/simulated/floor/reinforced/void,
/area/shuttle)
"Y" = (
/obj/structure/bed/chair/shuttle/black{
	dir = 1;
	pixel_x = 7;
	pixel_y = -13;
	buckle_pixel_shift = list("x"=7,"y"=-13,"z"=0)
	},
/turf/simulated/floor/reinforced/void,
/area/shuttle)

(1,1,1) = {"
E
E
E
E
E
E
E
E
E
E
E
P
"}
(2,1,1) = {"
E
U
T
U
U
b
N
r
p
e
g
E
"}
(3,1,1) = {"
E
U
n
U
U
U
U
U
U
d
M
E
"}
(4,1,1) = {"
E
U
U
U
U
U
U
U
U
U
I
E
"}
(5,1,1) = {"
E
U
Y
U
U
U
U
U
U
Q
c
E
"}
(6,1,1) = {"
E
U
U
U
y
s
f
y
y
e
B
E
"}
(7,1,1) = {"
E
E
E
E
E
E
E
E
E
E
E
E
"}
