//MAP CONVERTED BY dmm2tgm.py THIS HEADER COMMENT PREVENTS RECONVERSION, DO NOT REMOVE
"a" = (
/obj/effect/floor_decal/corner_techfloor_grid{
	dir = 6
	},
/obj/effect/floor_decal/techfloor/orange{
	dir = 1
	},
/obj/machinery/light{
	dir = 1
	},
/turf/simulated/floor/tiled/techfloor,
/area/shuttle)
"b" = (
/obj/effect/floor_decal/corner_techfloor_grid{
	dir = 1;
	layer = 2.02
	},
/obj/effect/floor_decal/techfloor/orange,
/turf/simulated/floor/tiled/techfloor,
/area/shuttle)
"c" = (
/obj/effect/floor_decal/corner_techfloor_grid{
	dir = 10
	},
/obj/effect/floor_decal/techfloor/orange{
	dir = 1
	},
/obj/machinery/light{
	dir = 1
	},
/turf/simulated/floor/tiled/techfloor,
/area/shuttle)
"d" = (
/obj/structure/table/steel_reinforced,
/obj/effect/floor_decal/techfloor/orange{
	dir = 8
	},
/turf/simulated/floor/tiled/techfloor,
/area/shuttle)
"g" = (
/obj/effect/floor_decal/techfloor/orange{
	dir = 4
	},
/obj/machinery/computer/ship/navigation{
	dir = 8
	},
/turf/simulated/floor/tiled/techfloor/grid,
/area/shuttle)
"n" = (
/turf/simulated/floor/tiled/techfloor,
/area/shuttle)
"q" = (
/obj/structure/bed/chair/shuttle/white,
/obj/effect/floor_decal/techfloor/orange{
	dir = 1
	},
/turf/simulated/floor/tiled/techfloor,
/area/shuttle)
"r" = (
/obj/effect/floor_decal/steeldecal/steel_decals_central6{
	dir = 4
	},
/turf/simulated/floor/tiled/techfloor,
/area/shuttle)
"s" = (
/obj/structure/bed/chair/shuttle/white{
	dir = 4
	},
/obj/effect/floor_decal/steeldecal/steel_decals_central4{
	dir = 4;
	pixel_y = -8
	},
/obj/effect/floor_decal/steeldecal/steel_decals10{
	dir = 1
	},
/obj/effect/floor_decal/steeldecal/steel_decals10{
	dir = 8
	},
/turf/simulated/floor/tiled/techfloor,
/area/shuttle)
"t" = (
/obj/machinery/computer/ship/helm{
	dir = 8
	},
/obj/effect/floor_decal/techfloor/orange{
	dir = 4
	},
/turf/simulated/floor/tiled/techfloor/grid,
/area/shuttle)
"u" = (
/obj/effect/floor_decal/steeldecal/steel_decals_central7,
/turf/simulated/floor/tiled/techfloor,
/area/shuttle)
"v" = (
/obj/effect/floor_decal/corner_techfloor_grid{
	dir = 6
	},
/obj/effect/floor_decal/techfloor/orange,
/obj/machinery/light,
/turf/simulated/floor/tiled/techfloor,
/area/shuttle)
"x" = (
/turf/simulated/wall/r_wall/hull,
/area/shuttle)
"C" = (
/obj/effect/floor_decal/techfloor/orange,
/turf/simulated/floor/tiled/techfloor,
/area/shuttle)
"D" = (
/obj/structure/bed/chair/shuttle/white,
/obj/effect/floor_decal/corner_techfloor_grid{
	dir = 8
	},
/obj/effect/floor_decal/techfloor/orange{
	dir = 1
	},
/turf/simulated/floor/tiled/techfloor,
/area/shuttle)
"E" = (
/obj/effect/floor_decal/techfloor/orange{
	dir = 5
	},
/turf/simulated/floor/tiled/techfloor/grid,
/area/shuttle)
"G" = (
/obj/effect/floor_decal/corner_techfloor_grid{
	dir = 4
	},
/obj/effect/floor_decal/techfloor/orange,
/turf/simulated/floor/tiled/techfloor,
/area/shuttle)
"J" = (
/obj/effect/floor_decal/industrial/loading,
/obj/effect/floor_decal/techfloor/orange,
/obj/effect/interior_entrypoint/vehicle/lander,
/turf/simulated/floor/tiled/techfloor,
/area/shuttle)
"L" = (
/obj/effect/floor_decal/corner_techfloor_grid{
	dir = 5
	},
/obj/effect/floor_decal/techfloor/orange,
/obj/machinery/light,
/turf/simulated/floor/tiled/techfloor,
/area/shuttle)
"N" = (
/obj/effect/floor_decal/steeldecal/steel_decals_central4{
	dir = 4;
	pixel_y = -8
	},
/obj/effect/floor_decal/steeldecal/steel_decals10{
	dir = 1
	},
/obj/effect/floor_decal/steeldecal/steel_decals10{
	dir = 8
	},
/obj/structure/bed/chair/comfy/vehicle{
	dir = 4
	},
/turf/simulated/floor/tiled/techfloor,
/area/shuttle)
"O" = (
/turf/simulated/floor/tiled/techfloor/grid,
/area/shuttle)
"P" = (
/obj/effect/floor_decal/techfloor/orange{
	dir = 6
	},
/obj/structure/table/steel_reinforced,
/turf/simulated/floor/tiled/techfloor/grid,
/area/shuttle)
"Q" = (
/obj/effect/floor_decal/steeldecal/steel_decals10{
	dir = 4
	},
/obj/effect/floor_decal/steeldecal/steel_decals10,
/turf/simulated/floor/tiled/techfloor,
/area/shuttle)
"T" = (
/obj/effect/floor_decal/techfloor/orange{
	dir = 10
	},
/turf/simulated/floor/tiled/techfloor,
/area/shuttle)
"U" = (
/obj/structure/bed/roller/hydraulic,
/obj/effect/floor_decal/techfloor/orange{
	dir = 9
	},
/turf/simulated/floor/tiled/techfloor,
/area/shuttle)
"V" = (
/obj/machinery/computer/ship/navigation/telescreen{
	pixel_y = 26
	},
/obj/effect/floor_decal/corner_techfloor_grid,
/obj/effect/floor_decal/techfloor/orange{
	dir = 1
	},
/obj/structure/bed/chair/shuttle/white,
/turf/simulated/floor/tiled/techfloor,
/area/shuttle)

(1,1,1) = {"
x
x
x
x
x
x
x
"}
(2,1,1) = {"
x
U
d
d
d
T
x
"}
(3,1,1) = {"
x
a
Q
u
Q
v
x
"}
(4,1,1) = {"
x
D
O
n
O
b
x
"}
(5,1,1) = {"
x
q
O
n
O
J
x
"}
(6,1,1) = {"
x
q
O
n
O
C
x
"}
(7,1,1) = {"
x
V
O
n
O
G
x
"}
(8,1,1) = {"
x
c
s
r
N
L
x
"}
(9,1,1) = {"
x
E
t
g
g
P
x
"}
(10,1,1) = {"
x
x
x
x
x
x
x
"}
