//MAP CONVERTED BY dmm2tgm.py THIS HEADER COMMENT PREVENTS RECONVERSION, DO NOT REMOVE
"am" = (
/obj/machinery/door/airlock/external,
/turf/simulated/floor/tiled/techfloor/grid,
/area/avalon/shelter/reactor)
"aT" = (
/turf/simulated/floor/reinforced,
/area/avalon/shelter/reactor)
"bk" = (
/obj/machinery/atmospherics/pipe/manifold4w/visible/cyan,
/obj/machinery/meter,
/turf/simulated/floor/tiled/techfloor,
/area/avalon/shelter/reactor)
"bn" = (
/obj/machinery/atmospherics/unary/vent_pump/siphon/on{
	dir = 8
	},
/turf/simulated/floor/reinforced/airless,
/area/avalon/shelter/reactor)
"bA" = (
/obj/machinery/atmospherics/pipe/simple/heat_exchanging/junction{
	dir = 8;
	surface = 0.01
	},
/turf/simulated/wall/r_wall/hull,
/area/avalon/shelter/reactor)
"bE" = (
/obj/machinery/atmospherics/pipe/zpipe/up/fuel{
	dir = 4
	},
/turf/simulated/floor/tiled/techfloor,
/area/avalon/shelter/reactor)
"bS" = (
/obj/machinery/atmospherics/pipe/simple/visible/cyan{
	dir = 4
	},
/turf/simulated/floor/reinforced,
/area/avalon/shelter/reactor)
"ca" = (
/obj/machinery/atmospherics/pipe/simple/visible/red{
	dir = 5
	},
/turf/simulated/floor/tiled/techfloor,
/area/avalon/shelter/reactor)
"cA" = (
/obj/machinery/atmospherics/pipe/simple/visible/cyan,
/obj/machinery/meter,
/turf/simulated/floor/tiled/techfloor/grid,
/area/avalon/shelter/reactor)
"cX" = (
/obj/machinery/atmospherics/pipe/simple/visible/fuel,
/turf/simulated/floor/reinforced,
/area/avalon/shelter/reactor)
"du" = (
/obj/machinery/atmospherics/pipe/simple/visible/cyan{
	dir = 9
	},
/turf/simulated/open,
/area/avalon/shelter/reactor)
"dI" = (
/obj/effect/floor_decal/industrial/warning/dust{
	dir = 5
	},
/turf/simulated/floor/reinforced/airless,
/area/avalon/shelter/reactor)
"ei" = (
/obj/machinery/atmospherics/pipe/simple/visible/cyan{
	dir = 10
	},
/turf/simulated/wall/r_wall/hull,
/area/avalon/shelter/reactor)
"eu" = (
/obj/machinery/atmospherics/pipe/simple/visible/red{
	dir = 5
	},
/obj/machinery/meter{
	uid = "F-M IN"
	},
/turf/simulated/floor/tiled/techfloor/grid,
/area/avalon/shelter/reactor)
"eZ" = (
/obj/machinery/atmospherics/pipe/zpipe/down/fuel{
	dir = 8
	},
/turf/simulated/open,
/area/avalon/shelter/reactor)
"fi" = (
/obj/machinery/atmospherics/pipe/simple/visible/red,
/obj/structure/cable/blue{
	icon_state = "5-8"
	},
/turf/simulated/floor/tiled/techfloor,
/area/avalon/shelter/reactor)
"fC" = (
/obj/machinery/atmospherics/pipe/zpipe/up/fuel{
	dir = 8
	},
/obj/machinery/atmospherics/unary/heat_exchanger{
	dir = 1
	},
/turf/simulated/floor/tiled/techfloor,
/area/avalon/shelter/reactor)
"fP" = (
/obj/machinery/atmospherics/portables_connector,
/obj/machinery/portable_atmospherics/canister/tungstenhexafluoride,
/obj/machinery/door/window/brigdoor/southright,
/turf/simulated/floor/tiled/techfloor/grid,
/area/avalon/shelter/reactor)
"gh" = (
/obj/machinery/atmospherics/unary/outlet_injector{
	dir = 1
	},
/obj/structure/lattice,
/obj/machinery/atmospherics/pipe/simple/heat_exchanging/reactorinterior{
	dir = 4
	},
/turf/simulated/open,
/area/avalon/shelter/reactor)
"gU" = (
/obj/machinery/atmospherics/unary/reactor_connector/outgoing,
/turf/simulated/floor/reinforced,
/area/avalon/shelter/reactor)
"hu" = (
/obj/machinery/atmospherics/pipe/simple/visible/red,
/turf/simulated/floor/tiled/techfloor,
/area/avalon/shelter/reactor)
"hA" = (
/obj/machinery/atmospherics/pipe/simple/visible/green{
	dir = 4
	},
/turf/simulated/wall/r_wall/hull,
/area/avalon/shelter/reactor)
"it" = (
/obj/machinery/atmospherics/unary/reactor_connector/ingoing{
	dir = 8;
	uid = "coolantout"
	},
/turf/simulated/floor/reinforced,
/area/avalon/shelter/reactor)
"ju" = (
/obj/machinery/door/airlock/external/glass/bolted,
/turf/simulated/floor/reinforced,
/area/avalon/shelter/reactor)
"jV" = (
/obj/effect/floor_decal/industrial/warning/dust{
	dir = 9
	},
/turf/simulated/floor/reinforced/airless,
/area/avalon/shelter/reactor)
"kO" = (
/obj/machinery/atmospherics/pipe/simple/visible/green{
	dir = 4
	},
/turf/simulated/floor/reinforced,
/area/avalon/shelter/reactor)
"lc" = (
/obj/machinery/atmospherics/pipe/simple/visible/red,
/turf/simulated/floor/tiled/techfloor/grid,
/area/avalon/shelter/reactor)
"lg" = (
/obj/machinery/atmospherics/pipe/manifold/visible/red{
	dir = 4
	},
/obj/machinery/meter{
	uid = "F-M OUT"
	},
/turf/simulated/floor/tiled/techfloor/grid,
/area/avalon/shelter/reactor)
"lv" = (
/obj/machinery/atmospherics/pipe/simple/visible/cyan{
	dir = 6
	},
/turf/simulated/floor/tiled/techfloor,
/area/avalon/shelter/reactor)
"lx" = (
/obj/machinery/atmospherics/pipe/simple/visible/red,
/turf/simulated/wall/r_wall/hull,
/area/avalon/shelter/reactor)
"lC" = (
/obj/effect/floor_decal/industrial/warning/corner{
	dir = 1
	},
/turf/simulated/floor/tiled/techfloor/grid,
/area/avalon/shelter/reactor)
"lJ" = (
/obj/machinery/atmospherics/binary/regulated_valve{
	dir = 4;
	uid = "REACTOR-F-V-OUT";
	forced_mass_flow = 500
	},
/obj/effect/floor_decal/industrial/outline/blue,
/turf/simulated/floor/tiled/techfloor/grid,
/area/avalon/shelter/reactor)
"mz" = (
/obj/machinery/atmospherics/portables_connector,
/obj/machinery/portable_atmospherics/canister/tungstenhexafluoride,
/obj/machinery/door/window/brigdoor/southleft,
/turf/simulated/floor/tiled/techfloor/grid,
/area/avalon/shelter/reactor)
"mA" = (
/obj/machinery/atmospherics/unary/reactor_connector/outgoing{
	dir = 4
	},
/turf/simulated/floor/reinforced,
/area/avalon/shelter/reactor)
"mM" = (
/obj/machinery/atmospherics/portables_connector{
	dir = 4
	},
/obj/machinery/portable_atmospherics/canister/liquid_helium,
/turf/simulated/floor/tiled/techfloor/grid,
/area/avalon/shelter/reactor)
"nd" = (
/obj/machinery/atmospherics/pipe/simple/visible/yellow{
	dir = 9
	},
/turf/simulated/floor/tiled/techfloor,
/area/avalon/shelter/reactor)
"nr" = (
/obj/abstract/level_data/player_level,
/turf/simulated/floor/reinforced,
/area/avalon/shelter/reactor)
"nC" = (
/obj/machinery/atmospherics/pipe/simple/visible/fuel,
/turf/simulated/wall/r_wall/hull,
/area/avalon/shelter/reactor)
"oy" = (
/obj/machinery/atmospherics/pipe/simple/visible/yellow,
/obj/machinery/meter,
/turf/simulated/floor/tiled/techfloor/grid,
/area/avalon/shelter/reactor)
"oz" = (
/obj/machinery/atmospherics/pipe/zpipe/up,
/turf/simulated/floor/reinforced,
/area/avalon/shelter/reactor)
"oM" = (
/obj/machinery/atmospherics/pipe/simple/visible/fuel{
	dir = 4
	},
/turf/simulated/floor/tiled/techfloor,
/area/avalon/shelter/reactor)
"oZ" = (
/obj/machinery/atmospherics/pipe/simple/visible/cyan,
/turf/simulated/floor/tiled/techfloor/grid,
/area/avalon/shelter/reactor)
"pa" = (
/obj/machinery/atmospherics/pipe/simple/visible/green{
	dir = 5
	},
/turf/simulated/floor/reinforced,
/area/avalon/shelter/reactor)
"pL" = (
/obj/machinery/atmospherics/unary/reactor_connector/outgoing{
	uid = "tungstenin"
	},
/turf/simulated/floor/reinforced,
/area/avalon/shelter/reactor)
"pP" = (
/obj/machinery/atmospherics/pipe/manifold/visible/green{
	dir = 4
	},
/turf/simulated/floor/reinforced,
/area/avalon/shelter/reactor)
"qI" = (
/turf/simulated/floor/tiled/techfloor/grid,
/area/avalon/shelter/reactor)
"rD" = (
/obj/effect/floor_decal/industrial/warning/corner{
	dir = 4
	},
/turf/simulated/floor/tiled/techfloor/grid,
/area/avalon/shelter/reactor)
"rX" = (
/obj/machinery/atmospherics/pipe/simple/visible/cyan{
	dir = 5
	},
/turf/simulated/floor/tiled/techfloor,
/area/avalon/shelter/reactor)
"so" = (
/obj/machinery/atmospherics/pipe/manifold/visible/cyan{
	dir = 8
	},
/turf/simulated/floor/tiled/techfloor,
/area/avalon/shelter/reactor)
"st" = (
/obj/machinery/atmospherics/pipe/simple/visible/cyan{
	dir = 6
	},
/turf/simulated/floor/reinforced/airless,
/area/avalon/shelter/reactor)
"sw" = (
/turf/simulated/floor/tiled/techfloor,
/area/avalon/shelter/reactor)
"sX" = (
/turf/simulated/open,
/area/avalon/shelter/reactor)
"th" = (
/obj/machinery/atmospherics/pipe/simple/visible/cyan{
	dir = 4
	},
/obj/machinery/meter,
/turf/simulated/floor/tiled/techfloor,
/area/avalon/shelter/reactor)
"tF" = (
/obj/machinery/atmospherics/pipe/simple/visible/green,
/turf/simulated/floor/reinforced,
/area/avalon/shelter/reactor)
"tN" = (
/obj/machinery/door/airlock/external/bolted,
/turf/simulated/floor/reinforced/airless,
/area/avalon/shelter/reactor)
"wm" = (
/obj/machinery/atmospherics/pipe/simple/visible/fuel{
	dir = 4
	},
/turf/simulated/floor/reinforced,
/area/avalon/shelter/reactor)
"wq" = (
/obj/machinery/atmospherics/portables_connector{
	dir = 8
	},
/obj/machinery/portable_atmospherics/canister/helium,
/turf/simulated/floor/tiled/techfloor/grid,
/area/avalon/shelter/reactor)
"wx" = (
/obj/machinery/atmospherics/binary/regulated_valve{
	dir = 4
	},
/obj/effect/floor_decal/industrial/outline/blue,
/turf/simulated/floor/tiled/techfloor,
/area/avalon/shelter/reactor)
"wD" = (
/obj/machinery/atmospherics/pipe/simple/visible/cyan{
	dir = 4
	},
/turf/simulated/floor/reinforced/airless,
/area/avalon/shelter/reactor)
"xh" = (
/obj/machinery/atmospherics/binary/pump/adv/on{
	flow_capacity = 500;
	power_rating = 70000
	},
/turf/simulated/floor/tiled/techfloor/grid,
/area/avalon/shelter/reactor)
"xv" = (
/obj/machinery/atmospherics/unary/reactor_connector/ingoing{
	uid = "tungstenout"
	},
/turf/simulated/floor/reinforced,
/area/avalon/shelter/reactor)
"xC" = (
/obj/machinery/atmospherics/pipe/manifold/visible/red{
	dir = 8
	},
/turf/simulated/floor/tiled/techfloor,
/area/avalon/shelter/reactor)
"yd" = (
/obj/machinery/atmospherics/pipe/simple/visible/cyan{
	dir = 9
	},
/turf/simulated/floor/tiled/techfloor,
/area/avalon/shelter/reactor)
"yC" = (
/obj/machinery/atmospherics/valve/shutoff,
/obj/effect/floor_decal/industrial/shutoff,
/obj/effect/floor_decal/industrial/outline/orange,
/turf/simulated/floor/tiled/techfloor/grid,
/area/avalon/shelter/reactor)
"zU" = (
/obj/machinery/atmospherics/pipe/simple/visible/cyan,
/turf/simulated/floor/tiled/techfloor,
/area/avalon/shelter/reactor)
"AX" = (
/obj/machinery/atmospherics/unary/reactor_connector/outgoing{
	dir = 8
	},
/turf/simulated/floor/reinforced,
/area/avalon/shelter/reactor)
"BA" = (
/obj/structure/cable/blue{
	icon_state = "2-9"
	},
/turf/simulated/floor/tiled/techfloor,
/area/avalon/shelter/reactor)
"BW" = (
/obj/machinery/atmospherics/pipe/zpipe/up/cyan,
/turf/simulated/floor/reinforced/airless,
/area/avalon/shelter/reactor)
"CD" = (
/obj/machinery/atmospherics/unary/vent_pump/siphon/on{
	dir = 4
	},
/turf/simulated/floor/reinforced/airless,
/area/avalon/shelter/reactor)
"Da" = (
/obj/machinery/atmospherics/pipe/simple/visible/cyan{
	dir = 5
	},
/turf/simulated/floor/reinforced/airless,
/area/avalon/shelter/reactor)
"Dl" = (
/obj/machinery/atmospherics/unary/outlet_injector{
	dir = 1
	},
/obj/structure/lattice,
/turf/simulated/open,
/area/avalon/shelter/reactor)
"Er" = (
/obj/machinery/atmospherics/pipe/simple/visible/cyan{
	dir = 4
	},
/obj/machinery/power/hybrid_reactor,
/turf/simulated/floor/reinforced/airless,
/area/avalon/shelter/reactor)
"ES" = (
/obj/machinery/atmospherics/pipe/simple/visible/red,
/obj/machinery/atmospherics/pipe/simple/visible/cyan{
	dir = 4
	},
/turf/simulated/floor/tiled/techfloor,
/area/avalon/shelter/reactor)
"EV" = (
/obj/machinery/atmospherics/pipe/manifold/visible/yellow{
	dir = 1
	},
/turf/simulated/floor/tiled/techfloor/grid,
/area/avalon/shelter/reactor)
"FB" = (
/obj/machinery/atmospherics/pipe/simple/visible/cyan{
	dir = 5
	},
/turf/simulated/open,
/area/avalon/shelter/reactor)
"Gg" = (
/obj/machinery/atmospherics/pipe/manifold/visible/green,
/turf/simulated/floor/reinforced,
/area/avalon/shelter/reactor)
"Gw" = (
/obj/machinery/atmospherics/pipe/simple/visible/green{
	dir = 6
	},
/turf/simulated/floor/reinforced,
/area/avalon/shelter/reactor)
"GF" = (
/obj/machinery/atmospherics/pipe/manifold/visible/cyan{
	dir = 4
	},
/turf/simulated/wall/r_wall/hull,
/area/avalon/shelter/reactor)
"HO" = (
/obj/machinery/atmospherics/pipe/simple/heat_exchanging/reactorinterior{
	dir = 10
	},
/turf/simulated/open,
/area/avalon/shelter/reactor)
"HW" = (
/obj/machinery/atmospherics/pipe/simple/visible/cyan{
	dir = 9
	},
/turf/simulated/floor/reinforced/airless,
/area/avalon/shelter/reactor)
"IW" = (
/obj/machinery/atmospherics/pipe/simple/heat_exchanging/reactorinterior{
	dir = 6
	},
/turf/simulated/open,
/area/avalon/shelter/reactor)
"Je" = (
/obj/machinery/atmospherics/pipe/simple/visible/green,
/obj/machinery/door/airlock/external,
/turf/simulated/floor/tiled/techfloor/grid,
/area/avalon/shelter/reactor)
"Jq" = (
/obj/machinery/atmospherics/pipe/simple/visible/green{
	dir = 10
	},
/turf/simulated/floor/tiled/techfloor,
/area/avalon/shelter/reactor)
"JD" = (
/obj/machinery/atmospherics/pipe/zpipe/down,
/turf/simulated/floor/tiled/techfloor/grid,
/area/avalon/shelter/reactor)
"Ka" = (
/obj/machinery/atmospherics/binary/pump/adv,
/obj/effect/floor_decal/industrial/outline/yellow,
/turf/simulated/floor/tiled/techfloor/grid,
/area/avalon/shelter/reactor)
"KV" = (
/obj/effect/floor_decal/industrial/warning{
	dir = 8
	},
/turf/simulated/floor/tiled/techfloor,
/area/avalon/shelter/reactor)
"KY" = (
/obj/machinery/atmospherics/valve/shutoff,
/obj/effect/floor_decal/industrial/shutoff,
/obj/effect/floor_decal/industrial/outline/orange,
/turf/simulated/floor/tiled/techfloor,
/area/avalon/shelter/reactor)
"Lf" = (
/obj/machinery/atmospherics/pipe/simple/visible/green{
	dir = 5
	},
/obj/machinery/meter,
/turf/simulated/floor/tiled/techfloor/grid,
/area/avalon/shelter/reactor)
"Lz" = (
/turf/simulated/floor/reinforced/airless,
/area/avalon/shelter/reactor)
"LI" = (
/obj/machinery/atmospherics/unary/outlet_injector{
	dir = 8
	},
/obj/structure/lattice,
/obj/machinery/atmospherics/pipe/zpipe/down/cyan,
/turf/simulated/open,
/area/avalon/shelter/reactor)
"LK" = (
/obj/machinery/atmospherics/portables_connector{
	dir = 8
	},
/obj/machinery/portable_atmospherics/canister/reactor{
	volume = 4000
	},
/turf/simulated/floor/tiled/techfloor/grid,
/area/avalon/shelter/reactor)
"Mb" = (
/obj/machinery/atmospherics/pipe/simple/visible/red,
/turf/simulated/floor/reinforced,
/area/avalon/shelter/reactor)
"Md" = (
/obj/machinery/atmospherics/pipe/manifold/visible/green{
	dir = 8
	},
/turf/simulated/floor/reinforced,
/area/avalon/shelter/reactor)
"MV" = (
/obj/machinery/atmospherics/pipe/simple/visible/yellow{
	dir = 5
	},
/turf/simulated/floor/tiled/techfloor,
/area/avalon/shelter/reactor)
"Nh" = (
/obj/machinery/atmospherics/pipe/simple/heat_exchanging/junction{
	dir = 4;
	surface = 0.02
	},
/turf/simulated/wall/r_wall/hull,
/area/avalon/shelter/reactor)
"NF" = (
/obj/effect/floor_decal/industrial/warning{
	dir = 4
	},
/turf/simulated/floor/tiled/techfloor,
/area/avalon/shelter/reactor)
"NG" = (
/obj/machinery/atmospherics/pipe/manifold/visible/red{
	dir = 4
	},
/turf/simulated/floor/tiled/techfloor,
/area/avalon/shelter/reactor)
"NZ" = (
/obj/machinery/atmospherics/pipe/simple/visible/cyan,
/turf/simulated/floor/reinforced/airless,
/area/avalon/shelter/reactor)
"PL" = (
/turf/simulated/wall/r_wall/hull,
/area/avalon/shelter/reactor)
"QE" = (
/obj/machinery/atmospherics/pipe/simple/visible/cyan{
	dir = 4
	},
/obj/machinery/atmospherics/unary/heat_exchanger,
/turf/simulated/floor/tiled/techfloor,
/area/avalon/shelter/reactor)
"QK" = (
/obj/machinery/atmospherics/pipe/simple/visible/cyan,
/obj/structure/cable/blue{
	icon_state = "6-10"
	},
/turf/simulated/floor/tiled/techfloor,
/area/avalon/shelter/reactor)
"QY" = (
/obj/machinery/atmospherics/pipe/manifold/visible/cyan,
/turf/simulated/floor/tiled/techfloor,
/area/avalon/shelter/reactor)
"Rw" = (
/obj/machinery/atmospherics/pipe/simple/visible/fuel{
	dir = 4
	},
/turf/simulated/wall/r_wall/hull,
/area/avalon/shelter/reactor)
"RD" = (
/obj/machinery/atmospherics/pipe/simple/visible/green{
	dir = 9
	},
/turf/simulated/floor/reinforced,
/area/avalon/shelter/reactor)
"Sq" = (
/obj/machinery/atmospherics/unary/outlet_injector{
	dir = 4
	},
/obj/structure/lattice,
/obj/machinery/atmospherics/pipe/zpipe/down/cyan,
/turf/simulated/open,
/area/avalon/shelter/reactor)
"St" = (
/obj/structure/lattice,
/obj/machinery/atmospherics/pipe/simple/heat_exchanging/reactorinterior{
	dir = 4
	},
/turf/simulated/open,
/area/avalon/shelter/reactor)
"SD" = (
/obj/machinery/atmospherics/pipe/simple/heat_exchanging/reactorinterior{
	dir = 5
	},
/turf/simulated/open,
/area/avalon/shelter/reactor)
"Tk" = (
/obj/machinery/atmospherics/pipe/zpipe/down/fuel{
	dir = 4
	},
/turf/simulated/open,
/area/avalon/shelter/reactor)
"Tt" = (
/obj/machinery/atmospherics/pipe/simple/visible/green{
	dir = 10
	},
/turf/simulated/floor/reinforced,
/area/avalon/shelter/reactor)
"TY" = (
/obj/abstract/map_data/example,
/turf/simulated/floor/reinforced,
/area/avalon/shelter/reactor)
"Uw" = (
/obj/machinery/atmospherics/pipe/simple/visible/cyan{
	dir = 10
	},
/turf/simulated/floor/tiled/techfloor,
/area/avalon/shelter/reactor)
"Vj" = (
/obj/machinery/atmospherics/binary/regulated_valve{
	dir = 4;
	uid = "REACTOR-F-V-IN"
	},
/obj/effect/floor_decal/industrial/outline/blue,
/turf/simulated/floor/tiled/techfloor/grid,
/area/avalon/shelter/reactor)
"Vk" = (
/obj/machinery/atmospherics/pipe/simple/visible/red{
	dir = 10
	},
/turf/simulated/floor/tiled/techfloor/grid,
/area/avalon/shelter/reactor)
"VZ" = (
/obj/machinery/atmospherics/unary/heater/reactor{
	dir = 4;
	uid = "heater"
	},
/turf/simulated/floor/tiled/techfloor/grid,
/area/avalon/shelter/reactor)
"WY" = (
/obj/machinery/atmospherics/unary/reactor_connector/outgoing{
	dir = 4;
	uid = "coolantin"
	},
/turf/simulated/floor/reinforced,
/area/avalon/shelter/reactor)
"Xg" = (
/obj/machinery/atmospherics/valve/digital,
/obj/effect/floor_decal/industrial/outline/blue,
/turf/simulated/floor/tiled/techfloor/grid,
/area/avalon/shelter/reactor)
"Xj" = (
/obj/effect/floor_decal/industrial/warning/dust{
	dir = 1
	},
/turf/simulated/floor/reinforced/airless,
/area/avalon/shelter/reactor)
"Ye" = (
/obj/machinery/atmospherics/pipe/simple/heat_exchanging/reactorinterior,
/turf/simulated/open,
/area/avalon/shelter/reactor)
"Yp" = (
/obj/machinery/door/airlock/external/bolted,
/turf/simulated/floor/reinforced,
/area/avalon/shelter/reactor)
"YF" = (
/obj/machinery/atmospherics/pipe/simple/visible/cyan{
	dir = 10
	},
/turf/simulated/floor/reinforced/airless,
/area/avalon/shelter/reactor)
"YG" = (
/obj/machinery/atmospherics/pipe/simple/heat_exchanging/reactorinterior{
	dir = 9
	},
/turf/simulated/open,
/area/avalon/shelter/reactor)
"YH" = (
/obj/machinery/atmospherics/pipe/simple/heat_exchanging/reactorinterior{
	dir = 10
	},
/obj/machinery/meter{
	uid = "REACTOR-M CHAMBER"
	},
/turf/simulated/open,
/area/avalon/shelter/reactor)
"YJ" = (
/obj/machinery/atmospherics/binary/pump/adv,
/obj/effect/floor_decal/industrial/outline/yellow,
/turf/simulated/floor/tiled/techfloor,
/area/avalon/shelter/reactor)
"Ze" = (
/obj/machinery/atmospherics/pipe/simple/visible/yellow,
/turf/simulated/wall/r_wall/hull,
/area/avalon/shelter/reactor)
"ZE" = (
/obj/machinery/atmospherics/pipe/simple/visible/cyan{
	dir = 4
	},
/turf/simulated/wall/r_wall/hull,
/area/avalon/shelter/reactor)
"ZZ" = (
/obj/effect/floor_decal/industrial/warning{
	dir = 1
	},
/turf/simulated/floor/tiled/techfloor,
/area/avalon/shelter/reactor)

(1,1,1) = {"
aT
aT
aT
aT
aT
aT
aT
aT
aT
aT
aT
aT
aT
aT
aT
aT
aT
aT
aT
aT
aT
aT
aT
aT
aT
aT
nr
"}
(2,1,1) = {"
aT
aT
aT
aT
aT
aT
aT
aT
aT
aT
aT
aT
aT
aT
aT
aT
aT
aT
aT
aT
aT
aT
aT
aT
aT
aT
aT
"}
(3,1,1) = {"
aT
aT
aT
aT
aT
aT
aT
aT
aT
aT
aT
aT
aT
aT
aT
aT
aT
aT
aT
aT
aT
aT
aT
aT
aT
aT
aT
"}
(4,1,1) = {"
aT
aT
aT
aT
aT
aT
aT
aT
aT
aT
aT
aT
aT
aT
aT
aT
aT
aT
aT
aT
aT
aT
aT
aT
aT
aT
aT
"}
(5,1,1) = {"
aT
aT
aT
aT
aT
aT
aT
aT
aT
aT
aT
aT
aT
aT
aT
aT
aT
aT
aT
aT
aT
aT
aT
aT
aT
aT
aT
"}
(6,1,1) = {"
aT
aT
aT
aT
aT
aT
aT
aT
aT
aT
aT
aT
aT
aT
aT
aT
aT
aT
aT
aT
aT
aT
aT
aT
aT
aT
aT
"}
(7,1,1) = {"
aT
aT
aT
aT
aT
aT
aT
aT
aT
aT
aT
aT
aT
aT
aT
aT
aT
aT
aT
aT
aT
aT
aT
aT
aT
aT
aT
"}
(8,1,1) = {"
aT
aT
aT
aT
aT
aT
aT
aT
aT
aT
aT
Gw
Md
Md
tF
tF
tF
tF
pa
aT
aT
aT
aT
aT
aT
aT
aT
"}
(9,1,1) = {"
aT
aT
aT
aT
aT
aT
aT
aT
aT
aT
aT
kO
kO
kO
aT
aT
aT
aT
kO
aT
aT
aT
aT
aT
aT
aT
aT
"}
(10,1,1) = {"
aT
aT
aT
aT
aT
aT
aT
aT
aT
aT
PL
hA
hA
hA
PL
PL
PL
aT
kO
aT
aT
aT
aT
aT
aT
aT
aT
"}
(11,1,1) = {"
aT
aT
aT
aT
aT
aT
aT
aT
aT
PL
PL
bn
bn
bn
BW
Da
PL
PL
kO
aT
aT
aT
aT
aT
aT
aT
aT
"}
(12,1,1) = {"
aT
aT
aT
aT
aT
aT
aT
aT
aT
PL
Lz
Lz
Lz
Lz
Lz
wD
Lz
PL
kO
aT
aT
aT
aT
aT
aT
aT
aT
"}
(13,1,1) = {"
aT
aT
aT
aT
aT
aT
aT
aT
aT
PL
Lz
Lz
Lz
st
NZ
HW
Lz
PL
kO
aT
aT
aT
aT
aT
aT
aT
aT
"}
(14,1,1) = {"
aT
aT
aT
aT
aT
aT
aT
aT
aT
PL
Lz
Lz
Lz
Er
Lz
Lz
Lz
PL
kO
aT
aT
aT
aT
aT
aT
aT
aT
"}
(15,1,1) = {"
aT
aT
aT
aT
aT
aT
aT
aT
aT
PL
Lz
Lz
Lz
YF
NZ
Da
Lz
PL
kO
aT
aT
aT
aT
aT
aT
aT
aT
"}
(16,1,1) = {"
aT
aT
aT
aT
aT
aT
aT
aT
aT
PL
Lz
Lz
Lz
Lz
Lz
wD
Lz
PL
kO
aT
aT
aT
aT
aT
aT
aT
aT
"}
(17,1,1) = {"
aT
aT
aT
aT
aT
aT
aT
aT
aT
PL
PL
CD
CD
CD
BW
HW
PL
PL
kO
aT
aT
aT
aT
aT
aT
aT
aT
"}
(18,1,1) = {"
aT
aT
aT
aT
aT
aT
aT
aT
aT
aT
PL
hA
hA
hA
PL
PL
PL
aT
kO
aT
aT
aT
aT
aT
aT
aT
aT
"}
(19,1,1) = {"
aT
aT
aT
aT
aT
aT
aT
aT
aT
aT
aT
kO
kO
kO
aT
aT
aT
oz
Gg
aT
aT
aT
aT
aT
aT
aT
aT
"}
(20,1,1) = {"
aT
aT
aT
aT
aT
aT
aT
aT
aT
aT
aT
Tt
pP
pP
tF
tF
tF
tF
RD
aT
aT
aT
aT
aT
aT
aT
aT
"}
(21,1,1) = {"
aT
aT
aT
aT
aT
aT
aT
aT
aT
aT
aT
aT
aT
aT
aT
aT
aT
aT
aT
aT
aT
aT
aT
aT
aT
aT
aT
"}
(22,1,1) = {"
aT
aT
aT
aT
aT
aT
aT
aT
aT
aT
aT
aT
aT
aT
aT
aT
aT
aT
aT
aT
aT
aT
aT
aT
aT
aT
aT
"}
(23,1,1) = {"
aT
aT
aT
aT
aT
aT
aT
aT
aT
aT
aT
aT
aT
aT
aT
aT
aT
aT
aT
aT
aT
aT
aT
aT
aT
aT
aT
"}
(24,1,1) = {"
aT
aT
aT
aT
aT
aT
aT
aT
aT
aT
aT
aT
aT
aT
aT
aT
aT
aT
aT
aT
aT
aT
aT
aT
aT
aT
aT
"}
(25,1,1) = {"
aT
aT
aT
aT
aT
aT
aT
aT
aT
aT
aT
aT
aT
aT
aT
aT
aT
aT
aT
aT
aT
aT
aT
aT
aT
aT
aT
"}
(26,1,1) = {"
aT
aT
aT
aT
aT
aT
aT
aT
aT
aT
aT
aT
aT
aT
aT
aT
aT
aT
aT
aT
aT
aT
aT
aT
aT
aT
aT
"}
(27,1,1) = {"
aT
aT
aT
aT
aT
aT
aT
aT
aT
aT
aT
aT
aT
aT
aT
aT
aT
aT
aT
aT
aT
aT
aT
aT
aT
aT
aT
"}

(1,1,2) = {"
aT
aT
aT
aT
aT
aT
aT
aT
aT
aT
aT
aT
aT
aT
aT
aT
aT
aT
aT
aT
aT
aT
aT
aT
aT
aT
nr
"}
(2,1,2) = {"
aT
aT
aT
aT
aT
aT
aT
aT
aT
aT
aT
aT
aT
aT
aT
aT
aT
aT
aT
aT
aT
aT
aT
aT
aT
aT
aT
"}
(3,1,2) = {"
aT
aT
aT
aT
aT
aT
aT
aT
aT
aT
aT
aT
aT
aT
aT
aT
aT
aT
aT
aT
aT
aT
aT
aT
aT
aT
aT
"}
(4,1,2) = {"
aT
aT
aT
aT
aT
aT
aT
aT
aT
aT
aT
aT
aT
aT
aT
WY
aT
aT
aT
aT
aT
aT
aT
aT
aT
aT
aT
"}
(5,1,2) = {"
aT
aT
aT
aT
aT
aT
aT
aT
aT
PL
PL
PL
PL
PL
aT
bS
aT
aT
aT
aT
aT
aT
aT
aT
aT
aT
aT
"}
(6,1,2) = {"
aT
aT
aT
aT
aT
aT
aT
aT
aT
PL
VZ
sw
sw
PL
PL
ZE
PL
PL
PL
PL
aT
aT
aT
aT
aT
aT
aT
"}
(7,1,2) = {"
aT
aT
aT
aT
aT
aT
PL
PL
PL
PL
Vk
hu
ca
qI
sw
Uw
cA
YJ
rX
PL
PL
PL
aT
aT
aT
aT
aT
"}
(8,1,2) = {"
aT
aT
aT
aT
pL
Mb
lx
hu
xC
xC
xh
KY
NG
eu
bE
lv
yC
so
QY
am
qI
PL
PL
aT
aT
aT
aT
"}
(9,1,2) = {"
aT
aT
aT
aT
aT
PL
PL
qI
LK
LK
PL
PL
PL
Vj
oM
th
PL
wq
wq
PL
qI
qI
PL
aT
aT
aT
aT
"}
(10,1,2) = {"
aT
aT
aT
aT
aT
PL
sw
sw
PL
PL
PL
PL
PL
Nh
Rw
ZE
PL
PL
PL
PL
PL
qI
PL
PL
PL
PL
aT
"}
(11,1,2) = {"
aT
aT
aT
aT
aT
PL
NF
NF
PL
PL
PL
IW
Ye
YG
LI
du
PL
PL
PL
PL
PL
qI
am
ZZ
sw
PL
aT
"}
(12,1,2) = {"
aT
aT
aT
aT
PL
PL
am
am
PL
PL
IW
YG
sX
sX
sX
sX
sX
PL
PL
PL
PL
PL
PL
lC
qI
PL
aT
"}
(13,1,2) = {"
aT
aT
aT
aT
PL
mz
MV
sw
PL
PL
St
sX
sX
sX
sX
sX
jV
PL
PL
PL
aT
aT
ju
sw
sw
PL
aT
"}
(14,1,2) = {"
aT
aT
aT
aT
PL
PL
EV
oy
Ka
Ze
gh
sX
sX
sX
sX
sX
Xj
tN
aT
PL
aT
aT
PL
sw
sw
Yp
aT
"}
(15,1,2) = {"
aT
aT
aT
aT
PL
fP
nd
sw
PL
PL
St
sX
sX
sX
sX
sX
dI
PL
aT
Yp
aT
aT
PL
sw
sw
PL
aT
"}
(16,1,2) = {"
aT
aT
aT
aT
PL
PL
am
am
PL
PL
YH
SD
sX
sX
sX
sX
sX
PL
PL
PL
PL
PL
PL
rD
qI
PL
aT
"}
(17,1,2) = {"
aT
aT
aT
aT
aT
PL
KV
KV
PL
PL
PL
HO
Ye
SD
Sq
FB
PL
PL
PL
PL
PL
qI
am
ZZ
sw
PL
aT
"}
(18,1,2) = {"
aT
aT
aT
aT
aT
PL
sw
sw
PL
PL
PL
PL
PL
bA
Rw
ZE
PL
PL
PL
PL
PL
qI
PL
PL
PL
PL
aT
"}
(19,1,2) = {"
aT
aT
aT
aT
aT
PL
PL
qI
mM
mM
PL
PL
PL
lJ
oM
wx
PL
JD
Lf
PL
qI
qI
PL
aT
aT
aT
aT
"}
(20,1,2) = {"
aT
aT
aT
aT
xv
Mb
lx
hu
ES
ES
lc
KY
fi
lg
fC
QE
oZ
rX
Jq
Je
qI
PL
PL
aT
aT
aT
aT
"}
(21,1,2) = {"
aT
aT
aT
aT
aT
aT
PL
PL
ei
GF
cA
QK
zU
oZ
YJ
bk
Xg
yd
sw
PL
PL
PL
aT
aT
aT
aT
aT
"}
(22,1,2) = {"
aT
aT
aT
aT
aT
aT
aT
aT
aT
PL
qI
sw
BA
PL
PL
ZE
PL
PL
PL
PL
aT
aT
aT
aT
aT
aT
aT
"}
(23,1,2) = {"
aT
aT
aT
aT
aT
aT
aT
aT
aT
PL
PL
PL
PL
PL
aT
bS
aT
aT
aT
aT
aT
aT
aT
aT
aT
aT
aT
"}
(24,1,2) = {"
aT
aT
aT
aT
aT
aT
aT
aT
aT
aT
aT
aT
aT
aT
aT
it
aT
aT
aT
aT
aT
aT
aT
aT
aT
aT
aT
"}
(25,1,2) = {"
aT
aT
aT
aT
aT
aT
aT
aT
aT
aT
aT
aT
aT
aT
aT
aT
aT
aT
aT
aT
aT
aT
aT
aT
aT
aT
aT
"}
(26,1,2) = {"
aT
aT
aT
aT
aT
aT
aT
aT
aT
aT
aT
aT
aT
aT
aT
aT
aT
aT
aT
aT
aT
aT
aT
aT
aT
aT
aT
"}
(27,1,2) = {"
aT
aT
aT
aT
aT
aT
aT
aT
aT
aT
aT
aT
aT
aT
aT
aT
aT
aT
aT
aT
aT
aT
aT
aT
aT
aT
aT
"}

(1,1,3) = {"
aT
aT
aT
aT
aT
aT
aT
aT
aT
aT
aT
aT
aT
aT
aT
aT
aT
aT
aT
aT
aT
aT
aT
aT
aT
aT
nr
"}
(2,1,3) = {"
aT
aT
aT
aT
aT
aT
aT
aT
aT
aT
aT
aT
aT
aT
aT
aT
aT
aT
aT
aT
aT
aT
aT
aT
aT
aT
TY
"}
(3,1,3) = {"
aT
aT
aT
aT
aT
aT
aT
aT
aT
aT
aT
aT
aT
aT
aT
aT
aT
aT
aT
aT
aT
aT
aT
aT
aT
aT
aT
"}
(4,1,3) = {"
aT
aT
aT
aT
aT
aT
aT
aT
aT
aT
aT
aT
aT
aT
aT
aT
aT
aT
aT
aT
aT
aT
aT
aT
aT
aT
aT
"}
(5,1,3) = {"
aT
aT
aT
aT
aT
aT
aT
aT
aT
aT
aT
aT
aT
aT
aT
aT
aT
aT
aT
aT
aT
aT
aT
aT
aT
aT
aT
"}
(6,1,3) = {"
aT
aT
aT
aT
aT
aT
aT
aT
aT
aT
aT
aT
aT
aT
aT
aT
aT
aT
aT
aT
aT
aT
aT
aT
aT
aT
aT
"}
(7,1,3) = {"
aT
aT
aT
aT
aT
aT
aT
aT
aT
aT
aT
aT
aT
PL
PL
PL
PL
aT
aT
aT
aT
aT
aT
aT
aT
aT
aT
"}
(8,1,3) = {"
aT
aT
aT
aT
aT
aT
aT
aT
aT
aT
aT
aT
aT
PL
Tk
aT
PL
aT
aT
aT
aT
aT
aT
aT
aT
aT
aT
"}
(9,1,3) = {"
aT
aT
aT
aT
aT
aT
aT
aT
aT
PL
PL
PL
PL
PL
wm
aT
PL
aT
aT
aT
aT
aT
aT
aT
aT
aT
aT
"}
(10,1,3) = {"
aT
aT
aT
aT
aT
aT
aT
aT
PL
PL
aT
aT
aT
aT
AX
aT
PL
aT
aT
aT
aT
aT
aT
aT
aT
aT
aT
"}
(11,1,3) = {"
aT
aT
aT
aT
aT
aT
aT
aT
PL
aT
aT
PL
PL
PL
PL
PL
PL
aT
aT
aT
aT
aT
aT
aT
aT
aT
aT
"}
(12,1,3) = {"
aT
aT
aT
aT
aT
aT
aT
PL
PL
aT
PL
PL
sX
sX
sX
PL
PL
aT
aT
aT
aT
aT
aT
aT
aT
aT
aT
"}
(13,1,3) = {"
aT
aT
aT
aT
aT
aT
aT
PL
aT
aT
PL
sX
sX
sX
sX
sX
PL
aT
aT
aT
aT
aT
aT
aT
aT
aT
aT
"}
(14,1,3) = {"
aT
aT
aT
aT
aT
aT
aT
PL
gU
cX
nC
Dl
sX
sX
sX
sX
PL
aT
aT
aT
aT
aT
aT
aT
aT
aT
aT
"}
(15,1,3) = {"
aT
aT
aT
aT
aT
aT
aT
PL
aT
aT
PL
sX
sX
sX
sX
sX
PL
aT
aT
aT
aT
aT
aT
aT
aT
aT
aT
"}
(16,1,3) = {"
aT
aT
aT
aT
aT
aT
aT
PL
PL
aT
PL
PL
sX
sX
sX
PL
PL
aT
aT
aT
aT
aT
aT
aT
aT
aT
aT
"}
(17,1,3) = {"
aT
aT
aT
aT
aT
aT
aT
aT
PL
aT
aT
PL
PL
PL
PL
PL
PL
aT
aT
aT
aT
aT
aT
aT
aT
aT
aT
"}
(18,1,3) = {"
aT
aT
aT
aT
aT
aT
aT
aT
PL
PL
aT
aT
aT
aT
mA
aT
PL
aT
aT
aT
aT
aT
aT
aT
aT
aT
aT
"}
(19,1,3) = {"
aT
aT
aT
aT
aT
aT
aT
aT
aT
PL
PL
PL
PL
PL
wm
aT
PL
aT
aT
aT
aT
aT
aT
aT
aT
aT
aT
"}
(20,1,3) = {"
aT
aT
aT
aT
aT
aT
aT
aT
aT
aT
aT
aT
aT
PL
eZ
aT
PL
aT
aT
aT
aT
aT
aT
aT
aT
aT
aT
"}
(21,1,3) = {"
aT
aT
aT
aT
aT
aT
aT
aT
aT
aT
aT
aT
aT
PL
PL
PL
PL
aT
aT
aT
aT
aT
aT
aT
aT
aT
aT
"}
(22,1,3) = {"
aT
aT
aT
aT
aT
aT
aT
aT
aT
aT
aT
aT
aT
aT
aT
aT
aT
aT
aT
aT
aT
aT
aT
aT
aT
aT
aT
"}
(23,1,3) = {"
aT
aT
aT
aT
aT
aT
aT
aT
aT
aT
aT
aT
aT
aT
aT
aT
aT
aT
aT
aT
aT
aT
aT
aT
aT
aT
aT
"}
(24,1,3) = {"
aT
aT
aT
aT
aT
aT
aT
aT
aT
aT
aT
aT
aT
aT
aT
aT
aT
aT
aT
aT
aT
aT
aT
aT
aT
aT
aT
"}
(25,1,3) = {"
aT
aT
aT
aT
aT
aT
aT
aT
aT
aT
aT
aT
aT
aT
aT
aT
aT
aT
aT
aT
aT
aT
aT
aT
aT
aT
aT
"}
(26,1,3) = {"
aT
aT
aT
aT
aT
aT
aT
aT
aT
aT
aT
aT
aT
aT
aT
aT
aT
aT
aT
aT
aT
aT
aT
aT
aT
aT
aT
"}
(27,1,3) = {"
aT
aT
aT
aT
aT
aT
aT
aT
aT
aT
aT
aT
aT
aT
aT
aT
aT
aT
aT
aT
aT
aT
aT
aT
aT
aT
aT
"}
