//MAP CONVERTED BY dmm2tgm.py THIS HEADER COMMENT PREVENTS RECONVERSION, DO NOT REMOVE
"nr" = (
/obj/abstract/level_data_spawner/player,
/turf/space,
/area/space)
"vK" = (
/turf/space,
/area/space)
"Er" = (
/obj/machinery/power/hybrid_reactor,
/turf/simulated/floor/reinforced/airless,
/area/serenity/shelter/engineering/reactor)
"Lz" = (
/turf/simulated/floor/reinforced/airless,
/area/serenity/shelter/engineering/reactor)
"PL" = (
/turf/simulated/wall/r_wall/hull,
/area/serenity/shelter/engineering/reactor)

(1,1,1) = {"
vK
vK
vK
vK
vK
vK
vK
vK
vK
vK
vK
vK
vK
vK
vK
vK
vK
vK
vK
vK
vK
vK
vK
vK
vK
vK
nr
"}
(2,1,1) = {"
vK
vK
vK
vK
vK
vK
vK
vK
vK
vK
vK
vK
vK
vK
vK
vK
vK
vK
vK
vK
vK
vK
vK
vK
vK
vK
vK
"}
(3,1,1) = {"
vK
vK
vK
vK
vK
vK
vK
vK
vK
vK
vK
vK
vK
vK
vK
vK
vK
vK
vK
vK
vK
vK
vK
vK
vK
vK
vK
"}
(4,1,1) = {"
vK
vK
vK
vK
vK
vK
vK
vK
vK
vK
vK
vK
vK
vK
vK
vK
vK
vK
vK
vK
vK
vK
vK
vK
vK
vK
vK
"}
(5,1,1) = {"
vK
vK
vK
vK
vK
vK
vK
vK
vK
vK
vK
vK
vK
vK
vK
vK
vK
vK
vK
vK
vK
vK
vK
vK
vK
vK
vK
"}
(6,1,1) = {"
vK
vK
vK
vK
vK
vK
vK
vK
vK
vK
vK
vK
vK
vK
vK
vK
vK
vK
vK
vK
vK
vK
vK
vK
vK
vK
vK
"}
(7,1,1) = {"
vK
vK
vK
vK
vK
vK
vK
vK
vK
vK
vK
vK
vK
vK
vK
vK
vK
vK
vK
vK
vK
vK
vK
vK
vK
vK
vK
"}
(8,1,1) = {"
vK
vK
vK
vK
vK
vK
vK
vK
vK
vK
PL
PL
PL
PL
PL
PL
PL
vK
vK
vK
vK
vK
vK
vK
vK
vK
vK
"}
(9,1,1) = {"
vK
vK
vK
vK
vK
vK
vK
vK
PL
PL
PL
PL
PL
PL
PL
PL
PL
PL
PL
vK
vK
vK
vK
vK
vK
vK
vK
"}
(10,1,1) = {"
vK
vK
vK
vK
vK
vK
vK
vK
PL
PL
PL
PL
PL
PL
PL
PL
PL
PL
PL
vK
vK
vK
vK
vK
vK
vK
vK
"}
(11,1,1) = {"
vK
vK
vK
vK
vK
vK
vK
PL
PL
PL
PL
Lz
Lz
Lz
Lz
Lz
PL
PL
PL
PL
vK
vK
vK
vK
vK
vK
vK
"}
(12,1,1) = {"
vK
vK
vK
vK
vK
vK
vK
PL
PL
PL
Lz
Lz
Lz
Lz
Lz
Lz
Lz
PL
PL
PL
vK
vK
vK
vK
vK
vK
vK
"}
(13,1,1) = {"
vK
vK
vK
vK
vK
vK
vK
PL
PL
PL
Lz
Lz
Lz
Lz
Lz
Lz
Lz
PL
PL
PL
vK
vK
vK
vK
vK
vK
vK
"}
(14,1,1) = {"
vK
vK
vK
vK
vK
vK
vK
PL
PL
PL
Lz
Lz
Lz
Er
Lz
Lz
Lz
PL
PL
PL
vK
vK
vK
vK
vK
vK
vK
"}
(15,1,1) = {"
vK
vK
vK
vK
vK
vK
vK
PL
PL
PL
Lz
Lz
Lz
Lz
Lz
Lz
Lz
PL
PL
PL
vK
vK
vK
vK
vK
vK
vK
"}
(16,1,1) = {"
vK
vK
vK
vK
vK
vK
vK
PL
PL
PL
Lz
Lz
Lz
Lz
Lz
Lz
Lz
PL
PL
PL
vK
vK
vK
vK
vK
vK
vK
"}
(17,1,1) = {"
vK
vK
vK
vK
vK
vK
vK
PL
PL
PL
PL
Lz
Lz
Lz
Lz
Lz
PL
PL
PL
PL
vK
vK
vK
vK
vK
vK
vK
"}
(18,1,1) = {"
vK
vK
vK
vK
vK
vK
vK
vK
PL
PL
PL
PL
PL
PL
PL
PL
PL
PL
PL
vK
vK
vK
vK
vK
vK
vK
vK
"}
(19,1,1) = {"
vK
vK
vK
vK
vK
vK
vK
vK
PL
PL
PL
PL
PL
PL
PL
PL
PL
PL
PL
vK
vK
vK
vK
vK
vK
vK
vK
"}
(20,1,1) = {"
vK
vK
vK
vK
vK
vK
vK
vK
vK
vK
PL
PL
PL
PL
PL
PL
PL
vK
vK
vK
vK
vK
vK
vK
vK
vK
vK
"}
(21,1,1) = {"
vK
vK
vK
vK
vK
vK
vK
vK
vK
vK
vK
vK
vK
vK
vK
vK
vK
vK
vK
vK
vK
vK
vK
vK
vK
vK
vK
"}
(22,1,1) = {"
vK
vK
vK
vK
vK
vK
vK
vK
vK
vK
vK
vK
vK
vK
vK
vK
vK
vK
vK
vK
vK
vK
vK
vK
vK
vK
vK
"}
(23,1,1) = {"
vK
vK
vK
vK
vK
vK
vK
vK
vK
vK
vK
vK
vK
vK
vK
vK
vK
vK
vK
vK
vK
vK
vK
vK
vK
vK
vK
"}
(24,1,1) = {"
vK
vK
vK
vK
vK
vK
vK
vK
vK
vK
vK
vK
vK
vK
vK
vK
vK
vK
vK
vK
vK
vK
vK
vK
vK
vK
vK
"}
(25,1,1) = {"
vK
vK
vK
vK
vK
vK
vK
vK
vK
vK
vK
vK
vK
vK
vK
vK
vK
vK
vK
vK
vK
vK
vK
vK
vK
vK
vK
"}
(26,1,1) = {"
vK
vK
vK
vK
vK
vK
vK
vK
vK
vK
vK
vK
vK
vK
vK
vK
vK
vK
vK
vK
vK
vK
vK
vK
vK
vK
vK
"}
(27,1,1) = {"
vK
vK
vK
vK
vK
vK
vK
vK
vK
vK
vK
vK
vK
vK
vK
vK
vK
vK
vK
vK
vK
vK
vK
vK
vK
vK
vK
"}
