//MAP CONVERTED BY dmm2tgm.py THIS HEADER COMMENT PREVENTS RECONVERSION, DO NOT REMOVE
"cx" = (
/turf/simulated/wall/r_wall/glowinghull,
/area/serenity/shelter/engineering/reactor)
"jF" = (
/obj/machinery/modernsuit_storage/engineering,
/turf/simulated/floor/reinforced,
/area/serenity/shelter/engineering/reactor)
"nr" = (
/obj/abstract/level_data_spawner/player,
/turf/space,
/area/space)
"tk" = (
/obj/effect/overmap_edge{
	edge_id = "reactor_insides";
	teleport_to_id = "reactor_chamber";
	icon = 'icons/obj/structures/ladders.dmi';
	icon_state = "ladder01";
	color = null
	},
/turf/simulated/floor/reinforced,
/area/serenity/shelter/engineering/reactor)
"vK" = (
/turf/space,
/area/space)
"wR" = (
/obj/machinery/light/small,
/obj/machinery/modernsuit_storage/engineering,
/turf/simulated/floor/reinforced,
/area/serenity/shelter/engineering/reactor)
"yP" = (
/obj/structure/sign/warning/internals_required{
	pixel_y = 32
	},
/turf/simulated/floor/reinforced,
/area/serenity/shelter/engineering/reactor)
"Er" = (
/obj/machinery/power/hybrid_reactor,
/turf/simulated/floor/reinforced,
/area/serenity/shelter/engineering/reactor)
"Fm" = (
/obj/machinery/door/airlock/external,
/turf/simulated/floor/reinforced,
/area/serenity/shelter/engineering/reactor)
"Jr" = (
/obj/structure/sign/warning/vacuum{
	pixel_y = 32
	},
/turf/simulated/floor/reinforced,
/area/serenity/shelter/engineering/reactor)
"JG" = (
/obj/machinery/light/small{
	dir = 8
	},
/turf/simulated/floor/reinforced,
/area/serenity/shelter/engineering/reactor)
"Lz" = (
/turf/simulated/floor/reinforced,
/area/serenity/shelter/engineering/reactor)
"PG" = (
/obj/structure/sign/warning/hot_exhaust{
	pixel_y = 32;
	pixel_x = 8
	},
/obj/structure/sign/warning/high_voltage{
	pixel_y = 32;
	pixel_x = -4
	},
/turf/simulated/floor/reinforced,
/area/serenity/shelter/engineering/reactor)
"PL" = (
/turf/simulated/wall/r_wall/hull,
/area/serenity/shelter/engineering/reactor)

(1,1,1) = {"
vK
vK
vK
vK
vK
vK
vK
vK
vK
vK
vK
vK
vK
vK
vK
vK
vK
vK
vK
vK
vK
vK
vK
vK
vK
vK
nr
"}
(2,1,1) = {"
vK
vK
vK
vK
vK
vK
vK
vK
vK
vK
vK
vK
vK
vK
vK
vK
vK
vK
vK
vK
vK
vK
vK
vK
vK
vK
vK
"}
(3,1,1) = {"
vK
vK
vK
vK
vK
vK
vK
vK
vK
vK
vK
vK
vK
vK
vK
vK
vK
vK
vK
vK
vK
vK
vK
vK
vK
vK
vK
"}
(4,1,1) = {"
vK
vK
vK
vK
vK
vK
vK
vK
vK
vK
vK
vK
vK
vK
vK
vK
vK
vK
vK
vK
vK
vK
vK
vK
vK
vK
vK
"}
(5,1,1) = {"
vK
vK
vK
vK
vK
vK
vK
vK
vK
vK
vK
vK
vK
vK
vK
vK
vK
vK
vK
vK
vK
vK
vK
vK
vK
vK
vK
"}
(6,1,1) = {"
vK
vK
vK
vK
vK
vK
vK
vK
vK
vK
vK
vK
vK
vK
vK
vK
vK
vK
vK
vK
vK
vK
vK
vK
vK
vK
vK
"}
(7,1,1) = {"
vK
vK
vK
vK
vK
vK
vK
vK
vK
vK
vK
vK
vK
vK
vK
vK
vK
vK
vK
vK
vK
vK
vK
vK
vK
vK
vK
"}
(8,1,1) = {"
vK
vK
vK
vK
vK
vK
vK
vK
vK
vK
PL
PL
PL
PL
PL
PL
PL
vK
vK
vK
vK
vK
vK
vK
vK
vK
vK
"}
(9,1,1) = {"
vK
vK
vK
vK
vK
vK
vK
vK
PL
PL
PL
PL
PL
PL
PL
PL
PL
PL
PL
vK
vK
vK
vK
vK
vK
vK
vK
"}
(10,1,1) = {"
vK
vK
vK
vK
vK
vK
vK
vK
PL
PL
cx
cx
cx
cx
cx
cx
cx
PL
PL
vK
vK
vK
vK
vK
vK
vK
vK
"}
(11,1,1) = {"
vK
vK
vK
vK
vK
vK
vK
PL
PL
cx
cx
Lz
Lz
Lz
Lz
Lz
cx
cx
PL
PL
vK
vK
vK
vK
vK
vK
vK
"}
(12,1,1) = {"
vK
vK
vK
vK
vK
vK
vK
PL
PL
cx
Lz
Lz
Lz
Lz
Lz
Lz
Lz
cx
PL
PL
PL
PL
PL
vK
vK
vK
vK
"}
(13,1,1) = {"
vK
vK
vK
vK
vK
vK
vK
PL
PL
cx
Lz
Lz
Lz
Lz
Lz
Lz
Lz
cx
PL
PL
PL
PL
PL
vK
vK
vK
vK
"}
(14,1,1) = {"
vK
vK
vK
vK
vK
vK
vK
PL
PL
cx
Lz
Lz
Lz
Er
Lz
Lz
Lz
Fm
JG
Lz
PL
PL
PL
vK
vK
vK
vK
"}
(15,1,1) = {"
vK
vK
vK
vK
vK
vK
vK
PL
PL
cx
Lz
Lz
Lz
Lz
Lz
Lz
Lz
cx
PL
Fm
PL
PL
PL
vK
vK
vK
vK
"}
(16,1,1) = {"
vK
vK
vK
vK
vK
vK
vK
PL
PL
cx
Lz
Lz
Lz
Lz
Lz
Lz
Lz
cx
PL
Jr
jF
PL
PL
vK
vK
vK
vK
"}
(17,1,1) = {"
vK
vK
vK
vK
vK
vK
vK
PL
PL
cx
cx
Lz
Lz
Lz
Lz
Lz
cx
cx
PL
PG
wR
PL
PL
vK
vK
vK
vK
"}
(18,1,1) = {"
vK
vK
vK
vK
vK
vK
vK
vK
PL
PL
cx
cx
cx
cx
cx
cx
cx
PL
PL
yP
tk
PL
PL
vK
vK
vK
vK
"}
(19,1,1) = {"
vK
vK
vK
vK
vK
vK
vK
vK
PL
PL
PL
PL
PL
PL
PL
PL
PL
PL
PL
PL
PL
PL
PL
vK
vK
vK
vK
"}
(20,1,1) = {"
vK
vK
vK
vK
vK
vK
vK
vK
vK
vK
PL
PL
PL
PL
PL
PL
PL
PL
PL
PL
PL
PL
PL
vK
vK
vK
vK
"}
(21,1,1) = {"
vK
vK
vK
vK
vK
vK
vK
vK
vK
vK
vK
vK
vK
vK
vK
vK
vK
vK
vK
vK
vK
vK
vK
vK
vK
vK
vK
"}
(22,1,1) = {"
vK
vK
vK
vK
vK
vK
vK
vK
vK
vK
vK
vK
vK
vK
vK
vK
vK
vK
vK
vK
vK
vK
vK
vK
vK
vK
vK
"}
(23,1,1) = {"
vK
vK
vK
vK
vK
vK
vK
vK
vK
vK
vK
vK
vK
vK
vK
vK
vK
vK
vK
vK
vK
vK
vK
vK
vK
vK
vK
"}
(24,1,1) = {"
vK
vK
vK
vK
vK
vK
vK
vK
vK
vK
vK
vK
vK
vK
vK
vK
vK
vK
vK
vK
vK
vK
vK
vK
vK
vK
vK
"}
(25,1,1) = {"
vK
vK
vK
vK
vK
vK
vK
vK
vK
vK
vK
vK
vK
vK
vK
vK
vK
vK
vK
vK
vK
vK
vK
vK
vK
vK
vK
"}
(26,1,1) = {"
vK
vK
vK
vK
vK
vK
vK
vK
vK
vK
vK
vK
vK
vK
vK
vK
vK
vK
vK
vK
vK
vK
vK
vK
vK
vK
vK
"}
(27,1,1) = {"
vK
vK
vK
vK
vK
vK
vK
vK
vK
vK
vK
vK
vK
vK
vK
vK
vK
vK
vK
vK
vK
vK
vK
vK
vK
vK
vK
"}
