//MAP CONVERTED BY dmm2tgm.py THIS HEADER COMMENT PREVENTS RECONVERSION, DO NOT REMOVE
"am" = (
/obj/machinery/door/airlock/external,
/turf/simulated/floor/tiled/techfloor/grid,
/area/serenity/shelter/engineering/reactor)
"aT" = (
/turf/simulated/floor/reinforced,
/area/serenity/shelter/engineering/reactor)
"bk" = (
/obj/machinery/atmospherics/pipe/manifold4w/visible/cyan,
/obj/machinery/meter,
/turf/simulated/floor/tiled/techfloor,
/area/serenity/shelter/engineering/reactor)
"bA" = (
/obj/machinery/atmospherics/pipe/simple/heat_exchanging/junction{
	dir = 8;
	surface = 0.01
	},
/turf/simulated/wall/r_wall/hull,
/area/serenity/shelter/engineering/reactor)
"bE" = (
/obj/machinery/atmospherics/pipe/zpipe/up/fuel{
	dir = 4
	},
/turf/simulated/floor/tiled/techfloor,
/area/serenity/shelter/engineering/reactor)
"bS" = (
/obj/machinery/atmospherics/pipe/simple/visible/cyan{
	dir = 4
	},
/turf/space,
/area/space)
"ca" = (
/obj/machinery/atmospherics/pipe/simple/visible/red{
	dir = 5
	},
/turf/simulated/floor/tiled/techfloor,
/area/serenity/shelter/engineering/reactor)
"cA" = (
/obj/machinery/atmospherics/pipe/simple/visible/cyan,
/obj/machinery/meter,
/turf/simulated/floor/tiled/techfloor/grid,
/area/serenity/shelter/engineering/reactor)
"cX" = (
/obj/machinery/atmospherics/pipe/simple/visible/fuel,
/turf/simulated/floor/reinforced,
/area/serenity/shelter/engineering/reactor)
"du" = (
/obj/machinery/atmospherics/pipe/simple/visible/cyan{
	dir = 9
	},
/turf/simulated/open/airless,
/area/serenity/shelter/engineering/reactor)
"dI" = (
/obj/effect/floor_decal/industrial/warning/dust{
	dir = 5
	},
/turf/simulated/open/airless,
/area/serenity/shelter/engineering/reactor)
"ei" = (
/obj/machinery/atmospherics/pipe/simple/visible/cyan{
	dir = 10
	},
/turf/simulated/wall/r_wall/hull,
/area/serenity/shelter/engineering/reactor)
"eu" = (
/obj/machinery/atmospherics/pipe/simple/visible/red{
	dir = 5
	},
/obj/machinery/meter{
	uid = "F-M IN"
	},
/turf/simulated/floor/tiled/techfloor/grid,
/area/serenity/shelter/engineering/reactor)
"eZ" = (
/obj/machinery/atmospherics/pipe/zpipe/down/fuel{
	dir = 8
	},
/turf/simulated/open,
/area/serenity/shelter/engineering/reactor)
"fi" = (
/obj/machinery/atmospherics/pipe/simple/visible/red,
/obj/structure/cable/blue{
	icon_state = "5-8"
	},
/turf/simulated/floor/tiled/techfloor,
/area/serenity/shelter/engineering/reactor)
"fC" = (
/obj/machinery/atmospherics/pipe/zpipe/up/fuel{
	dir = 8
	},
/obj/machinery/atmospherics/unary/heat_exchanger{
	dir = 1
	},
/turf/simulated/floor/tiled/techfloor,
/area/serenity/shelter/engineering/reactor)
"fP" = (
/obj/machinery/atmospherics/portables_connector,
/obj/machinery/portable_atmospherics/canister/tungstenhexafluoride,
/obj/machinery/door/window/brigdoor/southright,
/turf/simulated/floor/tiled/techfloor/grid,
/area/serenity/shelter/engineering/reactor)
"gh" = (
/obj/machinery/atmospherics/unary/outlet_injector{
	dir = 1
	},
/obj/structure/lattice,
/obj/machinery/atmospherics/pipe/simple/heat_exchanging/reactorinterior{
	dir = 4
	},
/turf/simulated/open/airless,
/area/serenity/shelter/engineering/reactor)
"hu" = (
/obj/machinery/atmospherics/pipe/simple/visible/red,
/turf/simulated/floor/tiled/techfloor,
/area/serenity/shelter/engineering/reactor)
"it" = (
/obj/machinery/atmospherics/unary/reactor_connector/ingoing{
	dir = 8;
	uid = "coolantout"
	},
/turf/space,
/area/space)
"ju" = (
/obj/machinery/door/airlock/external/glass/bolted,
/turf/simulated/floor/reinforced,
/area/serenity/shelter/engineering/reactor)
"jV" = (
/obj/effect/floor_decal/industrial/warning/dust{
	dir = 9
	},
/turf/simulated/open/airless,
/area/serenity/shelter/engineering/reactor)
"kO" = (
/obj/machinery/atmospherics/pipe/simple/visible/green{
	dir = 4
	},
/turf/space,
/area/space)
"lc" = (
/obj/machinery/atmospherics/pipe/simple/visible/red,
/turf/simulated/floor/tiled/techfloor/grid,
/area/serenity/shelter/engineering/reactor)
"lg" = (
/obj/machinery/atmospherics/pipe/manifold/visible/red{
	dir = 4
	},
/obj/machinery/meter{
	uid = "F-M OUT"
	},
/turf/simulated/floor/tiled/techfloor/grid,
/area/serenity/shelter/engineering/reactor)
"lv" = (
/obj/machinery/atmospherics/pipe/simple/visible/cyan{
	dir = 6
	},
/turf/simulated/floor/tiled/techfloor,
/area/serenity/shelter/engineering/reactor)
"lx" = (
/obj/machinery/atmospherics/pipe/simple/visible/red,
/turf/simulated/wall/r_wall/hull,
/area/serenity/shelter/engineering/reactor)
"lC" = (
/obj/effect/floor_decal/industrial/warning/corner{
	dir = 1
	},
/turf/simulated/floor/tiled/techfloor/grid,
/area/serenity/shelter/engineering/reactor)
"lJ" = (
/obj/effect/floor_decal/industrial/outline/blue,
/obj/machinery/atmospherics/pipe/simple/visible/red{
	dir = 4
	},
/turf/simulated/floor/tiled/techfloor/grid,
/area/serenity/shelter/engineering/reactor)
"mz" = (
/obj/machinery/atmospherics/portables_connector,
/obj/machinery/portable_atmospherics/canister/tungstenhexafluoride,
/obj/machinery/door/window/brigdoor/southleft,
/turf/simulated/floor/tiled/techfloor/grid,
/area/serenity/shelter/engineering/reactor)
"mM" = (
/obj/machinery/atmospherics/portables_connector{
	dir = 4
	},
/obj/machinery/portable_atmospherics/canister/liquid_helium,
/turf/simulated/floor/tiled/techfloor/grid,
/area/serenity/shelter/engineering/reactor)
"nd" = (
/obj/machinery/atmospherics/pipe/simple/visible/yellow{
	dir = 9
	},
/turf/simulated/floor/tiled/techfloor,
/area/serenity/shelter/engineering/reactor)
"nr" = (
/obj/abstract/level_data_spawner/player,
/turf/space,
/area/space)
"nF" = (
/obj/machinery/atmospherics/binary/regulated_valve{
	dir = 4;
	uid = "REACTOR-F-V-OUT";
	forced_mass_flow = 500
	},
/turf/simulated/wall/r_wall/hull,
/area/serenity/shelter/engineering/reactor)
"oy" = (
/obj/machinery/atmospherics/pipe/simple/visible/yellow,
/obj/machinery/meter,
/turf/simulated/floor/tiled/techfloor/grid,
/area/serenity/shelter/engineering/reactor)
"oz" = (
/obj/machinery/atmospherics/pipe/zpipe/up,
/turf/space,
/area/space)
"oM" = (
/obj/machinery/atmospherics/pipe/simple/visible/fuel{
	dir = 4
	},
/turf/simulated/floor/tiled/techfloor,
/area/serenity/shelter/engineering/reactor)
"oZ" = (
/obj/machinery/atmospherics/pipe/simple/visible/cyan,
/turf/simulated/floor/tiled/techfloor/grid,
/area/serenity/shelter/engineering/reactor)
"pa" = (
/obj/machinery/atmospherics/pipe/simple/visible/green{
	dir = 5
	},
/turf/space,
/area/space)
"pL" = (
/obj/machinery/atmospherics/unary/reactor_connector/outgoing{
	uid = "tungstenin"
	},
/turf/space,
/area/space)
"pP" = (
/obj/machinery/atmospherics/pipe/manifold/visible/green{
	dir = 4
	},
/turf/space,
/area/space)
"qI" = (
/turf/simulated/floor/tiled/techfloor/grid,
/area/serenity/shelter/engineering/reactor)
"rD" = (
/obj/effect/floor_decal/industrial/warning/corner{
	dir = 4
	},
/turf/simulated/floor/tiled/techfloor/grid,
/area/serenity/shelter/engineering/reactor)
"rX" = (
/obj/machinery/atmospherics/pipe/simple/visible/cyan{
	dir = 5
	},
/turf/simulated/floor/tiled/techfloor,
/area/serenity/shelter/engineering/reactor)
"so" = (
/obj/machinery/atmospherics/pipe/manifold/visible/cyan{
	dir = 8
	},
/turf/simulated/floor/tiled/techfloor,
/area/serenity/shelter/engineering/reactor)
"st" = (
/obj/machinery/atmospherics/pipe/simple/visible/cyan{
	dir = 6
	},
/turf/simulated/floor/reinforced/airless,
/area/serenity/shelter/engineering/reactor)
"sw" = (
/turf/simulated/floor/tiled/techfloor,
/area/serenity/shelter/engineering/reactor)
"sX" = (
/turf/simulated/open/airless,
/area/serenity/shelter/engineering/reactor)
"th" = (
/obj/machinery/atmospherics/pipe/simple/visible/cyan{
	dir = 4
	},
/obj/machinery/meter,
/turf/simulated/floor/tiled/techfloor,
/area/serenity/shelter/engineering/reactor)
"tF" = (
/obj/machinery/atmospherics/pipe/simple/visible/green,
/turf/space,
/area/space)
"tN" = (
/obj/machinery/door/airlock/external/bolted,
/turf/simulated/floor/reinforced/airless,
/area/serenity/shelter/engineering/reactor)
"vK" = (
/turf/space,
/area/space)
"wm" = (
/obj/machinery/atmospherics/pipe/simple/visible/fuel{
	dir = 4
	},
/turf/simulated/floor/reinforced,
/area/serenity/shelter/engineering/reactor)
"wq" = (
/obj/machinery/atmospherics/portables_connector{
	dir = 8
	},
/obj/machinery/portable_atmospherics/canister/helium,
/turf/simulated/floor/tiled/techfloor/grid,
/area/serenity/shelter/engineering/reactor)
"wx" = (
/obj/machinery/atmospherics/binary/regulated_valve{
	dir = 4
	},
/obj/effect/floor_decal/industrial/outline/blue,
/turf/simulated/floor/tiled/techfloor,
/area/serenity/shelter/engineering/reactor)
"wD" = (
/obj/machinery/atmospherics/pipe/simple/visible/cyan{
	dir = 4
	},
/turf/simulated/floor/reinforced/airless,
/area/serenity/shelter/engineering/reactor)
"xh" = (
/obj/machinery/atmospherics/binary/pump/adv/on{
	flow_capacity = 5000;
	power_rating = 70000
	},
/turf/simulated/floor/tiled/techfloor/grid,
/area/serenity/shelter/engineering/reactor)
"xv" = (
/obj/machinery/atmospherics/unary/reactor_connector/ingoing{
	uid = "tungstenout"
	},
/turf/space,
/area/space)
"xC" = (
/obj/machinery/atmospherics/pipe/manifold/visible/red{
	dir = 8
	},
/turf/simulated/floor/tiled/techfloor,
/area/serenity/shelter/engineering/reactor)
"yd" = (
/obj/machinery/atmospherics/pipe/simple/visible/cyan{
	dir = 9
	},
/turf/simulated/floor/tiled/techfloor,
/area/serenity/shelter/engineering/reactor)
"yC" = (
/obj/machinery/atmospherics/valve/shutoff,
/obj/effect/floor_decal/industrial/shutoff,
/obj/effect/floor_decal/industrial/outline/orange,
/turf/simulated/floor/tiled/techfloor/grid,
/area/serenity/shelter/engineering/reactor)
"zU" = (
/obj/machinery/atmospherics/pipe/simple/visible/cyan,
/turf/simulated/floor/tiled/techfloor,
/area/serenity/shelter/engineering/reactor)
"BA" = (
/obj/structure/cable/blue{
	icon_state = "2-9"
	},
/turf/simulated/floor/tiled/techfloor,
/area/serenity/shelter/engineering/reactor)
"BW" = (
/obj/machinery/atmospherics/pipe/zpipe/up/cyan,
/turf/simulated/floor/reinforced/airless,
/area/serenity/shelter/engineering/reactor)
"Da" = (
/obj/machinery/atmospherics/pipe/simple/visible/cyan{
	dir = 5
	},
/turf/simulated/floor/reinforced/airless,
/area/serenity/shelter/engineering/reactor)
"Er" = (
/obj/machinery/atmospherics/pipe/simple/visible/cyan{
	dir = 4
	},
/obj/machinery/power/hybrid_reactor,
/turf/simulated/floor/reinforced/airless,
/area/serenity/shelter/engineering/reactor)
"ES" = (
/obj/machinery/atmospherics/pipe/simple/visible/red,
/obj/machinery/atmospherics/pipe/simple/visible/cyan{
	dir = 4
	},
/turf/simulated/floor/tiled/techfloor,
/area/serenity/shelter/engineering/reactor)
"EV" = (
/obj/machinery/atmospherics/pipe/manifold/visible/yellow{
	dir = 1
	},
/turf/simulated/floor/tiled/techfloor/grid,
/area/serenity/shelter/engineering/reactor)
"FB" = (
/obj/machinery/atmospherics/pipe/simple/visible/cyan{
	dir = 5
	},
/turf/simulated/open/airless,
/area/serenity/shelter/engineering/reactor)
"Gg" = (
/obj/machinery/atmospherics/pipe/manifold/visible/green,
/turf/space,
/area/space)
"Gw" = (
/obj/machinery/atmospherics/pipe/simple/visible/green{
	dir = 6
	},
/turf/space,
/area/space)
"GF" = (
/obj/machinery/atmospherics/pipe/manifold/visible/cyan{
	dir = 4
	},
/turf/simulated/wall/r_wall/hull,
/area/serenity/shelter/engineering/reactor)
"HO" = (
/obj/machinery/atmospherics/pipe/simple/heat_exchanging/reactorinterior{
	dir = 10
	},
/turf/simulated/open/airless,
/area/serenity/shelter/engineering/reactor)
"HW" = (
/obj/machinery/atmospherics/pipe/simple/visible/cyan{
	dir = 9
	},
/turf/simulated/floor/reinforced/airless,
/area/serenity/shelter/engineering/reactor)
"IW" = (
/obj/machinery/atmospherics/pipe/simple/heat_exchanging/reactorinterior{
	dir = 6
	},
/turf/simulated/open/airless,
/area/serenity/shelter/engineering/reactor)
"Je" = (
/obj/machinery/atmospherics/pipe/simple/visible/green,
/obj/machinery/door/airlock/external,
/turf/simulated/floor/tiled/techfloor/grid,
/area/serenity/shelter/engineering/reactor)
"Jq" = (
/obj/machinery/atmospherics/pipe/simple/visible/green{
	dir = 10
	},
/turf/simulated/floor/tiled/techfloor,
/area/serenity/shelter/engineering/reactor)
"JD" = (
/obj/machinery/atmospherics/pipe/zpipe/down,
/turf/simulated/floor/tiled/techfloor/grid,
/area/serenity/shelter/engineering/reactor)
"Ka" = (
/obj/machinery/atmospherics/binary/pump/adv,
/obj/effect/floor_decal/industrial/outline/yellow,
/turf/simulated/floor/tiled/techfloor/grid,
/area/serenity/shelter/engineering/reactor)
"KV" = (
/obj/effect/floor_decal/industrial/warning{
	dir = 8
	},
/turf/simulated/floor/tiled/techfloor,
/area/serenity/shelter/engineering/reactor)
"Lf" = (
/obj/machinery/atmospherics/pipe/simple/visible/green{
	dir = 5
	},
/obj/machinery/meter,
/turf/simulated/floor/tiled/techfloor/grid,
/area/serenity/shelter/engineering/reactor)
"Lz" = (
/turf/simulated/floor/reinforced/airless,
/area/serenity/shelter/engineering/reactor)
"LI" = (
/obj/structure/lattice,
/obj/machinery/atmospherics/pipe/zpipe/down/cyan,
/turf/simulated/open/airless,
/area/serenity/shelter/engineering/reactor)
"LK" = (
/obj/machinery/atmospherics/portables_connector{
	dir = 8
	},
/obj/machinery/portable_atmospherics/canister/reactor{
	volume = 4000
	},
/turf/simulated/floor/tiled/techfloor/grid,
/area/serenity/shelter/engineering/reactor)
"Mb" = (
/obj/machinery/atmospherics/pipe/simple/visible/red,
/turf/space,
/area/space)
"Md" = (
/obj/machinery/atmospherics/pipe/manifold/visible/green{
	dir = 8
	},
/turf/space,
/area/space)
"MV" = (
/obj/machinery/atmospherics/pipe/simple/visible/yellow{
	dir = 5
	},
/turf/simulated/floor/tiled/techfloor,
/area/serenity/shelter/engineering/reactor)
"Nh" = (
/obj/machinery/atmospherics/pipe/simple/heat_exchanging/junction{
	dir = 4;
	surface = 0.02
	},
/turf/simulated/wall/r_wall/hull,
/area/serenity/shelter/engineering/reactor)
"NF" = (
/obj/effect/floor_decal/industrial/warning{
	dir = 4
	},
/turf/simulated/floor/tiled/techfloor,
/area/serenity/shelter/engineering/reactor)
"NG" = (
/obj/machinery/atmospherics/pipe/manifold/visible/red{
	dir = 4
	},
/turf/simulated/floor/tiled/techfloor,
/area/serenity/shelter/engineering/reactor)
"NZ" = (
/obj/machinery/atmospherics/pipe/simple/visible/cyan,
/turf/simulated/floor/reinforced/airless,
/area/serenity/shelter/engineering/reactor)
"PL" = (
/turf/simulated/wall/r_wall/hull,
/area/serenity/shelter/engineering/reactor)
"QE" = (
/obj/machinery/atmospherics/pipe/simple/visible/cyan{
	dir = 4
	},
/obj/machinery/atmospherics/unary/heat_exchanger,
/turf/simulated/floor/tiled/techfloor,
/area/serenity/shelter/engineering/reactor)
"QK" = (
/obj/machinery/atmospherics/pipe/simple/visible/cyan,
/obj/structure/cable/blue{
	icon_state = "6-10"
	},
/turf/simulated/floor/tiled/techfloor,
/area/serenity/shelter/engineering/reactor)
"QY" = (
/obj/machinery/atmospherics/pipe/manifold/visible/cyan,
/turf/simulated/floor/tiled/techfloor,
/area/serenity/shelter/engineering/reactor)
"RD" = (
/obj/machinery/atmospherics/pipe/simple/visible/green{
	dir = 9
	},
/turf/space,
/area/space)
"Sq" = (
/obj/machinery/atmospherics/pipe/zpipe/down/cyan,
/turf/simulated/open/airless,
/area/serenity/shelter/engineering/reactor)
"St" = (
/obj/structure/lattice,
/obj/machinery/atmospherics/pipe/simple/heat_exchanging/reactorinterior{
	dir = 4
	},
/turf/simulated/open/airless,
/area/serenity/shelter/engineering/reactor)
"SD" = (
/obj/machinery/atmospherics/pipe/simple/heat_exchanging/reactorinterior{
	dir = 5
	},
/turf/simulated/open/airless,
/area/serenity/shelter/engineering/reactor)
"Tk" = (
/obj/machinery/atmospherics/pipe/zpipe/down/fuel{
	dir = 4
	},
/turf/simulated/open,
/area/serenity/shelter/engineering/reactor)
"Tt" = (
/obj/machinery/atmospherics/pipe/simple/visible/green{
	dir = 10
	},
/turf/space,
/area/space)
"TY" = (
/obj/abstract/map_data/example,
/turf/space,
/area/space)
"Uw" = (
/obj/machinery/atmospherics/pipe/simple/visible/cyan{
	dir = 10
	},
/turf/simulated/floor/tiled/techfloor,
/area/serenity/shelter/engineering/reactor)
"Vj" = (
/obj/machinery/atmospherics/binary/regulated_valve{
	dir = 4;
	uid = "REACTOR-F-V-IN";
	forced_mass_flow = 2000
	},
/obj/effect/floor_decal/industrial/outline/blue,
/turf/simulated/floor/tiled/techfloor/grid,
/area/serenity/shelter/engineering/reactor)
"Vk" = (
/obj/machinery/atmospherics/pipe/simple/visible/red{
	dir = 10
	},
/turf/simulated/floor/tiled/techfloor/grid,
/area/serenity/shelter/engineering/reactor)
"VZ" = (
/obj/machinery/atmospherics/unary/heater/reactor{
	dir = 4;
	uid = "heater"
	},
/turf/simulated/floor/tiled/techfloor/grid,
/area/serenity/shelter/engineering/reactor)
"WY" = (
/obj/machinery/atmospherics/unary/reactor_connector/outgoing{
	dir = 4;
	uid = "coolantin"
	},
/turf/space,
/area/space)
"Xg" = (
/obj/machinery/atmospherics/valve/digital,
/obj/effect/floor_decal/industrial/outline/blue,
/turf/simulated/floor/tiled/techfloor/grid,
/area/serenity/shelter/engineering/reactor)
"Xj" = (
/obj/effect/floor_decal/industrial/warning/dust{
	dir = 1
	},
/turf/simulated/open/airless,
/area/serenity/shelter/engineering/reactor)
"Ye" = (
/obj/machinery/atmospherics/pipe/simple/heat_exchanging/reactorinterior,
/turf/simulated/open/airless,
/area/serenity/shelter/engineering/reactor)
"Yp" = (
/obj/machinery/door/airlock/external/bolted,
/turf/simulated/floor/reinforced,
/area/serenity/shelter/engineering/reactor)
"YF" = (
/obj/machinery/atmospherics/pipe/simple/visible/cyan{
	dir = 10
	},
/turf/simulated/floor/reinforced/airless,
/area/serenity/shelter/engineering/reactor)
"YG" = (
/obj/machinery/atmospherics/pipe/simple/heat_exchanging/reactorinterior{
	dir = 9
	},
/turf/simulated/open/airless,
/area/serenity/shelter/engineering/reactor)
"YH" = (
/obj/machinery/atmospherics/pipe/simple/heat_exchanging/reactorinterior{
	dir = 10
	},
/obj/machinery/meter{
	uid = "REACTOR-M CHAMBER"
	},
/turf/simulated/open/airless,
/area/serenity/shelter/engineering/reactor)
"YJ" = (
/obj/machinery/atmospherics/binary/pump/adv,
/obj/effect/floor_decal/industrial/outline/yellow,
/turf/simulated/floor/tiled/techfloor,
/area/serenity/shelter/engineering/reactor)
"Ze" = (
/obj/machinery/atmospherics/pipe/simple/visible/yellow,
/turf/simulated/wall/r_wall/hull,
/area/serenity/shelter/engineering/reactor)
"ZE" = (
/obj/machinery/atmospherics/pipe/simple/visible/cyan{
	dir = 4
	},
/turf/simulated/wall/r_wall/hull,
/area/serenity/shelter/engineering/reactor)
"ZZ" = (
/obj/effect/floor_decal/industrial/warning{
	dir = 1
	},
/turf/simulated/floor/tiled/techfloor,
/area/serenity/shelter/engineering/reactor)

(1,1,1) = {"
vK
vK
vK
vK
vK
vK
vK
vK
vK
vK
vK
vK
vK
vK
vK
vK
vK
vK
vK
vK
vK
vK
vK
vK
vK
vK
nr
"}
(2,1,1) = {"
vK
vK
vK
vK
vK
vK
vK
vK
vK
vK
vK
vK
vK
vK
vK
vK
vK
vK
vK
vK
vK
vK
vK
vK
vK
vK
vK
"}
(3,1,1) = {"
vK
vK
vK
vK
vK
vK
vK
vK
vK
vK
vK
vK
vK
vK
vK
vK
vK
vK
vK
vK
vK
vK
vK
vK
vK
vK
vK
"}
(4,1,1) = {"
vK
vK
vK
vK
vK
vK
vK
vK
vK
vK
vK
vK
vK
vK
vK
vK
vK
vK
vK
vK
vK
vK
vK
vK
vK
vK
vK
"}
(5,1,1) = {"
vK
vK
vK
vK
vK
vK
vK
vK
vK
vK
vK
vK
vK
vK
vK
vK
vK
vK
vK
vK
vK
vK
vK
vK
vK
vK
vK
"}
(6,1,1) = {"
vK
vK
vK
vK
vK
vK
vK
vK
vK
vK
vK
vK
vK
vK
vK
vK
vK
vK
vK
vK
vK
vK
vK
vK
vK
vK
vK
"}
(7,1,1) = {"
vK
vK
vK
vK
vK
vK
vK
vK
vK
vK
vK
vK
vK
vK
vK
vK
vK
vK
vK
vK
vK
vK
vK
vK
vK
vK
vK
"}
(8,1,1) = {"
vK
vK
vK
vK
vK
vK
vK
vK
vK
vK
vK
Gw
Md
Md
tF
tF
tF
tF
pa
vK
vK
vK
vK
vK
vK
vK
vK
"}
(9,1,1) = {"
vK
vK
vK
vK
vK
vK
vK
vK
vK
vK
vK
kO
kO
kO
vK
vK
vK
vK
kO
vK
vK
vK
vK
vK
vK
vK
vK
"}
(10,1,1) = {"
vK
vK
vK
vK
vK
vK
vK
vK
vK
vK
PL
PL
PL
PL
PL
PL
PL
vK
kO
vK
vK
vK
vK
vK
vK
vK
vK
"}
(11,1,1) = {"
vK
vK
vK
vK
vK
vK
vK
vK
vK
PL
PL
Lz
Lz
Lz
BW
Da
PL
PL
kO
vK
vK
vK
vK
vK
vK
vK
vK
"}
(12,1,1) = {"
vK
vK
vK
vK
vK
vK
vK
vK
vK
PL
Lz
Lz
Lz
Lz
Lz
wD
Lz
PL
kO
vK
vK
vK
vK
vK
vK
vK
vK
"}
(13,1,1) = {"
vK
vK
vK
vK
vK
vK
vK
vK
vK
PL
Lz
Lz
Lz
st
NZ
HW
Lz
PL
kO
vK
vK
vK
vK
vK
vK
vK
vK
"}
(14,1,1) = {"
vK
vK
vK
vK
vK
vK
vK
vK
vK
PL
Lz
Lz
Lz
Er
Lz
Lz
Lz
PL
kO
vK
vK
vK
vK
vK
vK
vK
vK
"}
(15,1,1) = {"
vK
vK
vK
vK
vK
vK
vK
vK
vK
PL
Lz
Lz
Lz
YF
NZ
Da
Lz
PL
kO
vK
vK
vK
vK
vK
vK
vK
vK
"}
(16,1,1) = {"
vK
vK
vK
vK
vK
vK
vK
vK
vK
PL
Lz
Lz
Lz
Lz
Lz
wD
Lz
PL
kO
vK
vK
vK
vK
vK
vK
vK
vK
"}
(17,1,1) = {"
vK
vK
vK
vK
vK
vK
vK
vK
vK
PL
PL
Lz
Lz
Lz
BW
HW
PL
PL
kO
vK
vK
vK
vK
vK
vK
vK
vK
"}
(18,1,1) = {"
vK
vK
vK
vK
vK
vK
vK
vK
vK
vK
PL
PL
PL
PL
PL
PL
PL
vK
kO
vK
vK
vK
vK
vK
vK
vK
vK
"}
(19,1,1) = {"
vK
vK
vK
vK
vK
vK
vK
vK
vK
vK
vK
kO
kO
kO
vK
vK
vK
oz
Gg
vK
vK
vK
vK
vK
vK
vK
vK
"}
(20,1,1) = {"
vK
vK
vK
vK
vK
vK
vK
vK
vK
vK
vK
Tt
pP
pP
tF
tF
tF
tF
RD
vK
vK
vK
vK
vK
vK
vK
vK
"}
(21,1,1) = {"
vK
vK
vK
vK
vK
vK
vK
vK
vK
vK
vK
vK
vK
vK
vK
vK
vK
vK
vK
vK
vK
vK
vK
vK
vK
vK
vK
"}
(22,1,1) = {"
vK
vK
vK
vK
vK
vK
vK
vK
vK
vK
vK
vK
vK
vK
vK
vK
vK
vK
vK
vK
vK
vK
vK
vK
vK
vK
vK
"}
(23,1,1) = {"
vK
vK
vK
vK
vK
vK
vK
vK
vK
vK
vK
vK
vK
vK
vK
vK
vK
vK
vK
vK
vK
vK
vK
vK
vK
vK
vK
"}
(24,1,1) = {"
vK
vK
vK
vK
vK
vK
vK
vK
vK
vK
vK
vK
vK
vK
vK
vK
vK
vK
vK
vK
vK
vK
vK
vK
vK
vK
vK
"}
(25,1,1) = {"
vK
vK
vK
vK
vK
vK
vK
vK
vK
vK
vK
vK
vK
vK
vK
vK
vK
vK
vK
vK
vK
vK
vK
vK
vK
vK
vK
"}
(26,1,1) = {"
vK
vK
vK
vK
vK
vK
vK
vK
vK
vK
vK
vK
vK
vK
vK
vK
vK
vK
vK
vK
vK
vK
vK
vK
vK
vK
vK
"}
(27,1,1) = {"
vK
vK
vK
vK
vK
vK
vK
vK
vK
vK
vK
vK
vK
vK
vK
vK
vK
vK
vK
vK
vK
vK
vK
vK
vK
vK
vK
"}

(1,1,2) = {"
vK
vK
vK
vK
vK
vK
vK
vK
vK
vK
vK
vK
vK
vK
vK
vK
vK
vK
vK
vK
vK
vK
vK
vK
vK
vK
nr
"}
(2,1,2) = {"
vK
vK
vK
vK
vK
vK
vK
vK
vK
vK
vK
vK
vK
vK
vK
vK
vK
vK
vK
vK
vK
vK
vK
vK
vK
vK
vK
"}
(3,1,2) = {"
vK
vK
vK
vK
vK
vK
vK
vK
vK
vK
vK
vK
vK
vK
vK
vK
vK
vK
vK
vK
vK
vK
vK
vK
vK
vK
vK
"}
(4,1,2) = {"
vK
vK
vK
vK
vK
vK
vK
vK
vK
vK
vK
vK
vK
vK
vK
WY
vK
vK
vK
vK
vK
vK
vK
vK
vK
vK
vK
"}
(5,1,2) = {"
vK
vK
vK
vK
vK
vK
vK
vK
vK
PL
PL
PL
PL
PL
vK
bS
vK
vK
vK
vK
vK
vK
vK
vK
vK
vK
vK
"}
(6,1,2) = {"
vK
vK
vK
vK
vK
vK
vK
vK
vK
PL
VZ
sw
sw
PL
PL
ZE
PL
PL
PL
PL
vK
vK
vK
vK
vK
vK
vK
"}
(7,1,2) = {"
vK
vK
vK
vK
vK
vK
PL
PL
PL
PL
Vk
hu
ca
qI
sw
Uw
cA
YJ
rX
PL
PL
PL
vK
vK
vK
vK
vK
"}
(8,1,2) = {"
vK
vK
vK
vK
pL
Mb
lx
hu
xC
xC
xh
hu
NG
eu
bE
lv
yC
so
QY
am
qI
PL
PL
vK
vK
vK
vK
"}
(9,1,2) = {"
vK
vK
vK
vK
vK
PL
PL
qI
LK
LK
PL
PL
PL
Vj
oM
th
PL
wq
wq
PL
qI
qI
PL
vK
vK
vK
vK
"}
(10,1,2) = {"
vK
vK
vK
vK
vK
PL
sw
sw
PL
PL
PL
PL
PL
Nh
PL
ZE
PL
PL
PL
PL
PL
qI
PL
PL
PL
PL
vK
"}
(11,1,2) = {"
vK
vK
vK
vK
vK
PL
NF
NF
PL
PL
PL
IW
Ye
YG
LI
du
PL
PL
PL
PL
PL
qI
am
ZZ
sw
PL
vK
"}
(12,1,2) = {"
vK
vK
vK
vK
PL
PL
am
am
PL
PL
IW
YG
sX
sX
sX
sX
sX
PL
PL
PL
PL
PL
PL
lC
qI
PL
vK
"}
(13,1,2) = {"
vK
vK
vK
vK
PL
mz
MV
sw
PL
PL
St
sX
sX
sX
sX
sX
jV
PL
PL
PL
aT
aT
ju
sw
sw
PL
vK
"}
(14,1,2) = {"
vK
vK
vK
vK
PL
PL
EV
oy
Ka
Ze
gh
sX
sX
sX
sX
sX
Xj
tN
aT
PL
aT
aT
PL
sw
sw
Yp
vK
"}
(15,1,2) = {"
vK
vK
vK
vK
PL
fP
nd
sw
PL
PL
St
sX
sX
sX
sX
sX
dI
PL
aT
Yp
aT
aT
PL
sw
sw
PL
vK
"}
(16,1,2) = {"
vK
vK
vK
vK
PL
PL
am
am
PL
PL
YH
SD
sX
sX
sX
sX
sX
PL
PL
PL
PL
PL
PL
rD
qI
PL
vK
"}
(17,1,2) = {"
vK
vK
vK
vK
vK
PL
KV
KV
PL
PL
PL
HO
Ye
SD
Sq
FB
PL
PL
PL
PL
PL
qI
am
ZZ
sw
PL
vK
"}
(18,1,2) = {"
vK
vK
vK
vK
vK
PL
sw
sw
PL
PL
PL
PL
PL
bA
PL
ZE
PL
PL
PL
PL
PL
qI
PL
PL
PL
PL
vK
"}
(19,1,2) = {"
vK
vK
vK
vK
vK
PL
PL
qI
mM
mM
PL
PL
nF
lJ
oM
wx
PL
JD
Lf
PL
qI
qI
PL
vK
vK
vK
vK
"}
(20,1,2) = {"
vK
vK
vK
vK
xv
Mb
lx
hu
ES
ES
lc
hu
fi
lg
fC
QE
oZ
rX
Jq
Je
qI
PL
PL
vK
vK
vK
vK
"}
(21,1,2) = {"
vK
vK
vK
vK
vK
vK
PL
PL
ei
GF
cA
QK
zU
oZ
YJ
bk
Xg
yd
sw
PL
PL
PL
vK
vK
vK
vK
vK
"}
(22,1,2) = {"
vK
vK
vK
vK
vK
vK
vK
vK
vK
PL
qI
sw
BA
PL
PL
ZE
PL
PL
PL
PL
vK
vK
vK
vK
vK
vK
vK
"}
(23,1,2) = {"
vK
vK
vK
vK
vK
vK
vK
vK
vK
PL
PL
PL
PL
PL
vK
bS
vK
vK
vK
vK
vK
vK
vK
vK
vK
vK
vK
"}
(24,1,2) = {"
vK
vK
vK
vK
vK
vK
vK
vK
vK
vK
vK
vK
vK
vK
vK
it
vK
vK
vK
vK
vK
vK
vK
vK
vK
vK
vK
"}
(25,1,2) = {"
vK
vK
vK
vK
vK
vK
vK
vK
vK
vK
vK
vK
vK
vK
vK
vK
vK
vK
vK
vK
vK
vK
vK
vK
vK
vK
vK
"}
(26,1,2) = {"
vK
vK
vK
vK
vK
vK
vK
vK
vK
vK
vK
vK
vK
vK
vK
vK
vK
vK
vK
vK
vK
vK
vK
vK
vK
vK
vK
"}
(27,1,2) = {"
vK
vK
vK
vK
vK
vK
vK
vK
vK
vK
vK
vK
vK
vK
vK
vK
vK
vK
vK
vK
vK
vK
vK
vK
vK
vK
vK
"}

(1,1,3) = {"
vK
vK
vK
vK
vK
vK
vK
vK
vK
vK
vK
vK
vK
vK
vK
vK
vK
vK
vK
vK
vK
vK
vK
vK
vK
vK
nr
"}
(2,1,3) = {"
vK
vK
vK
vK
vK
vK
vK
vK
vK
vK
vK
vK
vK
vK
vK
vK
vK
vK
vK
vK
vK
vK
vK
vK
vK
vK
TY
"}
(3,1,3) = {"
vK
vK
vK
vK
vK
vK
vK
vK
vK
vK
vK
vK
vK
vK
vK
vK
vK
vK
vK
vK
vK
vK
vK
vK
vK
vK
vK
"}
(4,1,3) = {"
vK
vK
vK
vK
vK
vK
vK
vK
vK
vK
vK
vK
vK
vK
vK
vK
vK
vK
vK
vK
vK
vK
vK
vK
vK
vK
vK
"}
(5,1,3) = {"
vK
vK
vK
vK
vK
vK
vK
vK
vK
vK
vK
vK
vK
vK
vK
vK
vK
vK
vK
vK
vK
vK
vK
vK
vK
vK
vK
"}
(6,1,3) = {"
vK
vK
vK
vK
vK
vK
vK
vK
vK
vK
vK
vK
vK
vK
vK
vK
vK
vK
vK
vK
vK
vK
vK
vK
vK
vK
vK
"}
(7,1,3) = {"
vK
vK
vK
vK
vK
vK
vK
vK
vK
vK
vK
vK
vK
PL
PL
PL
PL
vK
vK
vK
vK
vK
vK
vK
vK
vK
vK
"}
(8,1,3) = {"
vK
vK
vK
vK
vK
vK
vK
vK
vK
vK
vK
vK
vK
PL
Tk
aT
PL
vK
vK
vK
vK
vK
vK
vK
vK
vK
vK
"}
(9,1,3) = {"
vK
vK
vK
vK
vK
vK
vK
vK
vK
PL
PL
PL
PL
PL
wm
aT
PL
vK
vK
vK
vK
vK
vK
vK
vK
vK
vK
"}
(10,1,3) = {"
vK
vK
vK
vK
vK
vK
vK
vK
PL
PL
aT
aT
aT
aT
aT
aT
PL
vK
vK
vK
vK
vK
vK
vK
vK
vK
vK
"}
(11,1,3) = {"
vK
vK
vK
vK
vK
vK
vK
vK
PL
aT
aT
PL
PL
PL
PL
PL
PL
vK
vK
vK
vK
vK
vK
vK
vK
vK
vK
"}
(12,1,3) = {"
vK
vK
vK
vK
vK
vK
vK
PL
PL
aT
PL
PL
sX
sX
sX
PL
PL
vK
vK
vK
vK
vK
vK
vK
vK
vK
vK
"}
(13,1,3) = {"
vK
vK
vK
vK
vK
vK
vK
PL
aT
aT
PL
sX
sX
sX
sX
sX
PL
vK
vK
vK
vK
vK
vK
vK
vK
vK
vK
"}
(14,1,3) = {"
vK
vK
vK
vK
vK
vK
vK
PL
aT
cX
PL
sX
sX
sX
sX
sX
PL
vK
vK
vK
vK
vK
vK
vK
vK
vK
vK
"}
(15,1,3) = {"
vK
vK
vK
vK
vK
vK
vK
PL
aT
aT
PL
sX
sX
sX
sX
sX
PL
vK
vK
vK
vK
vK
vK
vK
vK
vK
vK
"}
(16,1,3) = {"
vK
vK
vK
vK
vK
vK
vK
PL
PL
aT
PL
PL
sX
sX
sX
PL
PL
vK
vK
vK
vK
vK
vK
vK
vK
vK
vK
"}
(17,1,3) = {"
vK
vK
vK
vK
vK
vK
vK
vK
PL
aT
aT
PL
PL
PL
PL
PL
PL
vK
vK
vK
vK
vK
vK
vK
vK
vK
vK
"}
(18,1,3) = {"
vK
vK
vK
vK
vK
vK
vK
vK
PL
PL
aT
aT
aT
aT
aT
aT
PL
vK
vK
vK
vK
vK
vK
vK
vK
vK
vK
"}
(19,1,3) = {"
vK
vK
vK
vK
vK
vK
vK
vK
vK
PL
PL
PL
PL
PL
wm
aT
PL
vK
vK
vK
vK
vK
vK
vK
vK
vK
vK
"}
(20,1,3) = {"
vK
vK
vK
vK
vK
vK
vK
vK
vK
vK
vK
vK
vK
PL
eZ
aT
PL
vK
vK
vK
vK
vK
vK
vK
vK
vK
vK
"}
(21,1,3) = {"
vK
vK
vK
vK
vK
vK
vK
vK
vK
vK
vK
vK
vK
PL
PL
PL
PL
vK
vK
vK
vK
vK
vK
vK
vK
vK
vK
"}
(22,1,3) = {"
vK
vK
vK
vK
vK
vK
vK
vK
vK
vK
vK
vK
vK
vK
vK
vK
vK
vK
vK
vK
vK
vK
vK
vK
vK
vK
vK
"}
(23,1,3) = {"
vK
vK
vK
vK
vK
vK
vK
vK
vK
vK
vK
vK
vK
vK
vK
vK
vK
vK
vK
vK
vK
vK
vK
vK
vK
vK
vK
"}
(24,1,3) = {"
vK
vK
vK
vK
vK
vK
vK
vK
vK
vK
vK
vK
vK
vK
vK
vK
vK
vK
vK
vK
vK
vK
vK
vK
vK
vK
vK
"}
(25,1,3) = {"
vK
vK
vK
vK
vK
vK
vK
vK
vK
vK
vK
vK
vK
vK
vK
vK
vK
vK
vK
vK
vK
vK
vK
vK
vK
vK
vK
"}
(26,1,3) = {"
vK
vK
vK
vK
vK
vK
vK
vK
vK
vK
vK
vK
vK
vK
vK
vK
vK
vK
vK
vK
vK
vK
vK
vK
vK
vK
vK
"}
(27,1,3) = {"
vK
vK
vK
vK
vK
vK
vK
vK
vK
vK
vK
vK
vK
vK
vK
vK
vK
vK
vK
vK
vK
vK
vK
vK
vK
vK
vK
"}
