//MAP CONVERTED BY dmm2tgm.py THIS HEADER COMMENT PREVENTS RECONVERSION, DO NOT REMOVE
"a" = (
/turf/simulated/wall/concrete,
/area/surface/tent)
"r" = (
/obj/effect/interior_entrypoint/tent,
/turf/simulated/floor/holofloor/snow,
/area/surface/tent)
"Q" = (
/turf/simulated/floor/holofloor/snow,
/area/surface/tent)

(1,1,1) = {"
a
a
a
a
a
"}
(2,1,1) = {"
a
Q
Q
r
a
"}
(3,1,1) = {"
a
Q
Q
Q
a
"}
(4,1,1) = {"
a
a
a
a
a
"}
