//MAP CONVERTED BY dmm2tgm.py THIS HEADER COMMENT PREVENTS RECONVERSION, DO NOT REMOVE
"aL" = (
/obj/abstract/landmark/start,
/turf/simulated/floor/tiled/dark,
/area/space)
"ck" = (
/obj/item/scanner/gas,
/obj/item/scanner/gas,
/obj/item/scanner/gas,
/obj/item/scanner/gas,
/obj/structure/table,
/turf/simulated/floor/tiled/dark,
/area/space)
"co" = (
/turf/simulated/floor/tiled/monotile,
/area/space)
"cV" = (
/obj/machinery/atmospherics/unary/vent_pump/siphon/on{
	dir = 8
	},
/turf/simulated/floor/reinforced/airless,
/area/space)
"du" = (
/obj/machinery/atmospherics/binary/pump/high_power/buildable{
	dir = 1
	},
/turf/simulated/floor/tiled/dark,
/area/space)
"dE" = (
/obj/machinery/optable,
/turf/simulated/floor/tiled/dark,
/area/space)
"fa" = (
/mob/living/carbon/human,
/turf/simulated/floor/tiled/dark,
/area/space)
"gT" = (
/obj/machinery/atmospherics/binary/pump/high_power/buildable{
	dir = 4
	},
/turf/simulated/floor/tiled/dark,
/area/space)
"he" = (
/obj/machinery/portable_atmospherics/canister/nitrogen,
/turf/simulated/floor/tiled/dark,
/area/space)
"jg" = (
/obj/machinery/atmospherics/pipe/simple/visible{
	dir = 5
	},
/turf/simulated/floor/tiled/dark,
/area/space)
"jB" = (
/turf/simulated/wall/r_wall,
/area/space)
"kw" = (
/obj/structure/cable{
	dir = 4
	},
/obj/machinery/power/terminal{
	dir = 4
	},
/turf/simulated/floor/tiled/dark,
/area/space)
"la" = (
/obj/machinery/light/spot{
	dir = 4
	},
/turf/simulated/floor/tiled/dark,
/area/space)
"lN" = (
/obj/machinery/portable_atmospherics/canister/carbon_dioxide/engine_setup,
/turf/simulated/floor/tiled/dark,
/area/space)
"mc" = (
/obj/machinery/sleeper,
/turf/simulated/floor/tiled/dark,
/area/space)
"nL" = (
/obj/machinery/atmospherics/portables_connector,
/turf/simulated/floor/tiled/dark,
/area/space)
"ou" = (
/obj/structure/rack,
/obj/item/gun/projectile/shotgun/pump,
/obj/item/gun/projectile/automatic/assault_rifle,
/turf/simulated/floor/tiled/dark,
/area/space)
"oy" = (
/obj/item/gun/energy/lasercannon,
/obj/item/gun/energy/lasercannon,
/obj/item/gun/energy/lasercannon,
/obj/item/gun/energy/lasercannon,
/obj/structure/table,
/turf/simulated/floor/tiled/dark,
/area/space)
"oB" = (
/turf/simulated/wall/r_wall/hull,
/area/space)
"oZ" = (
/obj/structure/cable{
	icon_state = "4-8"
	},
/obj/structure/cable{
	icon_state = "0-8"
	},
/obj/machinery/power/apc/high{
	dir = 1
	},
/obj/machinery/light/spot{
	dir = 1
	},
/turf/simulated/floor/tiled/dark,
/area/space)
"rg" = (
/obj/machinery/atmospherics/pipe/simple/visible{
	dir = 10
	},
/turf/simulated/floor/tiled/dark,
/area/space)
"rH" = (
/obj/structure/rack,
/obj/item/gun/projectile/automatic/smg/usi,
/turf/simulated/floor/tiled/dark,
/area/space)
"sQ" = (
/obj/machinery/power/generator/port_gen/pacman/super/potato,
/obj/structure/cable{
	dir = 8
	},
/turf/simulated/floor/tiled/dark,
/area/space)
"sT" = (
/obj/machinery/atmospherics/portables_connector{
	dir = 1
	},
/turf/simulated/floor/tiled/dark,
/area/space)
"th" = (
/obj/machinery/power/generator/smes/buildable/preset,
/obj/structure/cable{
	dir = 8
	},
/turf/simulated/floor/tiled/dark,
/area/space)
"tl" = (
/obj/machinery/atmospherics/unary/heater,
/turf/simulated/floor/tiled/dark,
/area/space)
"uZ" = (
/turf/simulated/floor/reinforced/airless,
/area/space)
"vg" = (
/obj/machinery/atmospherics/portables_connector{
	dir = 4
	},
/turf/simulated/floor/tiled/dark,
/area/space)
"vK" = (
/obj/machinery/portable_atmospherics/canister/hydrogen,
/turf/simulated/floor/tiled/dark,
/area/space)
"vZ" = (
/obj/machinery/light/spot,
/obj/structure/table,
/turf/simulated/floor/tiled/dark,
/area/space)
"wj" = (
/obj/machinery/power/breakerbox,
/obj/structure/cable{
	icon_state = "4-8"
	},
/turf/simulated/floor/tiled/dark,
/area/space)
"wP" = (
/obj/machinery/portable_atmospherics/canister/helium,
/obj/machinery/light/spot,
/turf/simulated/floor/tiled/dark,
/area/space)
"xq" = (
/obj/abstract/level_data/main_level,
/turf/simulated/floor/tiled/monotile,
/area/space)
"xR" = (
/obj/structure/table,
/obj/item/multitool,
/obj/item/multitool,
/obj/item/multitool,
/obj/item/multitool,
/obj/machinery/light/spot,
/turf/simulated/floor/tiled/dark,
/area/space)
"xT" = (
/obj/machinery/portable_atmospherics/canister/carbon_dioxide/engine_setup,
/obj/machinery/light/spot,
/turf/simulated/floor/tiled/dark,
/area/space)
"Bs" = (
/obj/machinery/light/spot{
	dir = 1
	},
/turf/simulated/floor/tiled/dark,
/area/space)
"CO" = (
/obj/machinery/atmospherics/unary/freezer,
/turf/simulated/floor/tiled/dark,
/area/space)
"DA" = (
/obj/machinery/atmospherics/binary/pump/high_power/buildable,
/turf/simulated/floor/tiled/dark,
/area/space)
"Ed" = (
/obj/machinery/portable_atmospherics/canister/methyl_bromide,
/turf/simulated/floor/tiled/dark,
/area/space)
"Er" = (
/obj/structure/cable{
	icon_state = "2-8"
	},
/turf/simulated/floor/tiled/dark,
/area/space)
"EM" = (
/obj/machinery/atmospherics/pipe/simple/visible{
	dir = 6
	},
/turf/simulated/floor/tiled/dark,
/area/space)
"Hk" = (
/obj/structure/table,
/obj/machinery/light/spot{
	dir = 8
	},
/turf/simulated/floor/tiled/dark,
/area/space)
"JH" = (
/obj/machinery/portable_atmospherics/canister/oxygen,
/turf/simulated/floor/tiled/dark,
/area/space)
"JS" = (
/obj/abstract/landmark/latejoin,
/turf/simulated/floor/tiled/dark,
/area/space)
"KJ" = (
/obj/structure/cable,
/obj/machinery/power/debug_items/infinite_cable_powersink,
/turf/simulated/floor/tiled/dark,
/area/space)
"La" = (
/obj/machinery/atmospherics/pipe/simple/visible{
	dir = 10
	},
/obj/machinery/meter,
/turf/simulated/floor/tiled/dark,
/area/space)
"Ly" = (
/obj/structure/table,
/obj/item/stack/material/puck/mapped/uranium/fifty,
/turf/simulated/floor/tiled/dark,
/area/space)
"LP" = (
/obj/machinery/atmospherics/unary/outlet_injector/buildable{
	dir = 8
	},
/turf/simulated/floor/reinforced/airless,
/area/space)
"OI" = (
/obj/machinery/atmospherics/pipe/simple/visible{
	dir = 9
	},
/obj/machinery/meter,
/turf/simulated/floor/tiled/dark,
/area/space)
"Pp" = (
/obj/structure/table,
/obj/item/storage/toolbox/electrical,
/obj/item/storage/toolbox/electrical,
/obj/item/storage/toolbox/electrical,
/turf/simulated/floor/tiled/dark,
/area/space)
"Qc" = (
/obj/structure/table,
/obj/item/storage/firstaid/surgery,
/turf/simulated/floor/tiled/dark,
/area/space)
"RF" = (
/obj/structure/cable{
	icon_state = "4-8"
	},
/turf/simulated/floor/tiled/dark,
/area/space)
"RV" = (
/obj/machinery/bodyscanner,
/turf/simulated/floor/tiled/dark,
/area/space)
"Ss" = (
/obj/structure/table,
/turf/simulated/floor/tiled/dark,
/area/space)
"Sv" = (
/obj/structure/window/borosilicate_reinforced/full,
/obj/structure/wall_frame/hull,
/turf/simulated/floor/tiled/dark,
/area/space)
"Ts" = (
/obj/machinery/atmospherics/pipe/manifold,
/turf/simulated/floor/tiled/dark,
/area/space)
"UH" = (
/obj/machinery/light/spot,
/obj/abstract/landmark/latejoin,
/turf/simulated/floor/tiled/dark,
/area/space)
"Wj" = (
/obj/machinery/atmospherics/binary/pump/high_power/buildable{
	dir = 8
	},
/turf/simulated/floor/tiled/dark,
/area/space)
"WF" = (
/turf/simulated/floor/tiled/dark,
/area/space)
"WU" = (
/obj/machinery/atmospherics/pipe/simple/visible{
	dir = 9
	},
/turf/simulated/floor/tiled/dark,
/area/space)
"WW" = (
/obj/structure/cable{
	icon_state = "4-8"
	},
/obj/machinery/power/sensor,
/turf/simulated/floor/tiled/dark,
/area/space)
"XZ" = (
/obj/machinery/atmospherics/pipe/manifold{
	dir = 8
	},
/turf/simulated/floor/tiled/dark,
/area/space)
"Yp" = (
/obj/machinery/atmospherics/pipe/simple/visible{
	dir = 4
	},
/obj/machinery/meter,
/turf/simulated/wall/r_wall/hull,
/area/space)
"Yt" = (
/obj/structure/table,
/obj/item/chems/drinks/bottle/vodka,
/obj/item/chems/drinks/bottle/vodka,
/obj/item/chems/drinks/bottle/vodka,
/turf/simulated/floor/tiled/dark,
/area/space)

(1,1,1) = {"
co
co
co
co
co
co
co
co
co
co
co
co
co
co
co
co
co
co
co
co
co
co
co
co
co
co
co
co
co
jB
jB
jB
jB
jB
jB
jB
jB
jB
jB
jB
jB
jB
jB
jB
jB
co
co
co
co
co
co
xq
"}
(2,1,1) = {"
co
co
co
co
co
co
co
co
co
co
co
co
co
co
co
co
co
co
co
co
co
co
co
co
co
co
co
co
co
jB
fa
WF
WF
Hk
WF
rH
jB
WF
mc
WF
WF
WF
WF
Ss
jB
jB
jB
jB
jB
jB
jB
co
"}
(3,1,1) = {"
co
co
co
co
co
co
co
co
co
co
co
co
co
co
co
co
co
co
co
co
co
co
co
co
co
co
co
co
co
jB
fa
WF
WF
Ss
WF
ou
jB
WF
RV
WF
WF
WF
WF
Ss
jB
aL
aL
aL
aL
aL
jB
co
"}
(4,1,1) = {"
co
co
co
co
co
co
co
co
co
co
co
co
co
co
co
co
co
co
co
co
co
co
co
co
co
co
co
co
co
jB
fa
WF
WF
Ss
WF
WF
jB
Qc
WF
WF
WF
WF
WF
Ss
jB
JS
JS
JS
JS
JS
jB
co
"}
(5,1,1) = {"
co
co
co
co
co
co
co
co
co
co
co
co
co
co
co
co
co
co
co
co
co
co
co
co
co
co
co
co
co
jB
fa
WF
WF
WF
WF
WF
jB
dE
WF
WF
la
WF
WF
WF
jB
aL
aL
aL
aL
aL
jB
co
"}
(6,1,1) = {"
co
co
co
co
co
co
co
co
co
co
co
co
co
co
co
co
co
co
co
co
co
co
co
co
co
co
co
co
jB
jB
jB
jB
jB
jB
WF
jB
jB
jB
jB
jB
jB
jB
WF
jB
jB
JS
JS
JS
JS
UH
jB
co
"}
(7,1,1) = {"
co
co
co
co
co
co
co
co
co
co
co
co
co
co
co
co
co
co
co
co
co
co
co
co
co
co
co
co
jB
WF
WF
WF
WF
WF
WF
WF
WF
WF
WF
WF
WF
WF
WF
WF
jB
WF
WF
WF
WF
WF
jB
co
"}
(8,1,1) = {"
co
co
co
co
co
co
co
co
co
co
co
co
co
co
co
co
co
co
co
co
co
co
co
co
co
co
co
co
jB
WF
WF
WF
WF
WF
WF
WF
WF
WF
WF
WF
WF
WF
WF
WF
WF
WF
WF
WF
WF
WF
jB
co
"}
(9,1,1) = {"
co
co
co
co
co
co
co
co
co
co
co
co
co
co
co
co
co
co
co
co
co
co
co
co
co
co
co
co
jB
WF
la
WF
WF
WF
WF
WF
WF
WF
la
WF
WF
WF
WF
WF
jB
WF
WF
WF
WF
WF
jB
co
"}
(10,1,1) = {"
co
co
co
co
co
co
co
co
co
co
co
co
co
co
co
co
co
co
co
co
co
co
co
co
co
co
jB
jB
jB
jB
jB
WF
jB
jB
jB
jB
jB
jB
jB
jB
jB
WF
WF
jB
jB
jB
jB
jB
jB
jB
jB
co
"}
(11,1,1) = {"
co
co
co
co
co
co
co
co
co
co
co
co
co
co
co
co
co
co
co
co
co
co
co
co
co
co
jB
sQ
WF
Ly
Yt
WF
WF
jB
WF
WF
nL
XZ
DA
XZ
sT
WF
WF
WF
jB
co
co
co
co
co
co
co
"}
(12,1,1) = {"
co
co
co
co
co
co
co
co
co
co
co
co
co
co
co
co
co
co
co
co
co
co
co
co
co
co
jB
kw
WF
WF
WF
WF
WF
jB
WF
WF
WF
La
du
OI
WF
WF
WF
WF
jB
co
co
co
co
co
co
co
"}
(13,1,1) = {"
co
co
co
co
co
co
co
co
co
co
co
co
co
co
co
co
co
co
co
co
co
co
co
co
co
co
jB
th
WF
WF
WF
WF
WF
jB
Bs
EM
jg
WF
WF
WF
WF
WF
WF
vZ
jB
co
co
co
co
co
co
co
"}
(14,1,1) = {"
co
co
co
co
co
co
co
co
co
co
co
co
co
co
co
co
co
co
co
co
co
co
co
co
co
co
jB
RF
WF
WF
WF
WF
WF
jB
CO
Ts
La
DA
sT
WF
WF
WF
WF
ck
jB
co
co
co
co
co
co
co
"}
(15,1,1) = {"
co
co
co
co
co
co
co
co
co
co
co
co
co
co
co
co
co
co
co
co
co
co
co
co
co
co
jB
oZ
WF
WF
WF
WF
xR
jB
tl
Ts
EM
du
sT
WF
WF
WF
WF
Ss
jB
co
co
co
co
co
co
co
"}
(16,1,1) = {"
co
co
co
co
co
co
co
co
co
co
co
co
co
co
co
co
co
co
co
co
co
co
co
co
co
co
jB
WW
WF
WF
WF
WF
Pp
jB
WF
rg
WU
WF
WF
WF
WF
WF
WF
WF
jB
co
co
co
co
co
co
co
"}
(17,1,1) = {"
co
co
co
co
co
co
co
co
co
co
co
co
co
co
co
co
co
co
co
co
co
co
co
co
co
co
jB
RF
WF
WF
WF
WF
Ss
jB
WF
WF
WF
WF
WF
WF
WF
WF
he
he
jB
co
co
co
co
co
co
co
"}
(18,1,1) = {"
co
co
co
co
co
co
co
co
co
co
co
co
co
co
co
co
co
co
co
co
co
co
co
co
co
co
jB
wj
WF
WF
WF
WF
WF
jB
Bs
vg
vg
WF
WF
WF
WF
WF
WF
wP
jB
co
co
co
co
co
co
co
"}
(19,1,1) = {"
co
co
co
co
co
co
co
co
co
co
co
co
co
co
co
co
co
co
co
co
co
co
co
co
co
co
jB
Er
KJ
WF
WF
WF
WF
jB
WF
gT
Wj
WF
WF
WF
WF
WF
WF
Ed
jB
co
co
co
co
co
co
co
"}
(20,1,1) = {"
co
co
co
co
co
co
co
co
co
co
co
co
co
co
co
co
co
co
co
co
co
co
co
co
co
co
jB
jB
jB
jB
jB
jB
jB
oB
oB
Yp
Yp
oB
Bs
WF
WF
WF
WF
WF
jB
co
co
co
co
co
co
co
"}
(21,1,1) = {"
co
co
co
co
co
co
co
co
co
co
co
co
co
co
co
co
co
co
co
co
co
co
co
co
co
co
co
co
co
co
co
co
co
oB
uZ
LP
cV
Sv
WF
WF
WF
WF
WF
WF
jB
co
co
co
co
co
co
co
"}
(22,1,1) = {"
co
co
co
co
co
co
co
co
co
co
co
co
co
co
co
co
co
co
co
co
co
co
co
co
co
co
co
co
co
co
co
co
co
oB
uZ
uZ
uZ
Sv
WF
WF
lN
lN
lN
xT
jB
co
co
co
co
co
co
co
"}
(23,1,1) = {"
co
co
co
co
co
co
co
co
co
co
co
co
co
co
co
co
co
co
co
co
co
co
co
co
co
co
co
co
co
co
co
co
co
oB
uZ
uZ
uZ
Sv
WF
WF
JH
JH
JH
JH
jB
co
co
co
co
co
co
co
"}
(24,1,1) = {"
co
co
co
co
co
co
co
co
co
co
co
co
co
co
co
co
co
co
co
co
co
co
co
co
co
co
co
co
co
co
co
co
co
oB
uZ
uZ
uZ
Sv
WF
oy
vK
vK
vK
vK
jB
co
co
co
co
co
co
co
"}
(25,1,1) = {"
co
co
co
co
co
co
co
co
co
co
co
co
co
co
co
co
co
co
co
co
co
co
co
co
co
co
co
co
co
co
co
co
co
oB
oB
oB
oB
oB
jB
jB
jB
jB
jB
jB
jB
co
co
co
co
co
co
co
"}
(26,1,1) = {"
co
co
co
co
co
co
co
co
co
co
co
co
co
co
co
co
co
co
co
co
co
co
co
co
co
co
co
co
co
co
co
co
co
co
co
co
co
co
co
co
co
co
co
co
co
co
co
co
co
co
co
co
"}
(27,1,1) = {"
co
co
co
co
co
co
co
co
co
co
co
co
co
co
co
co
co
co
co
co
co
co
co
co
co
co
co
co
co
co
co
co
co
co
co
co
co
co
co
co
co
co
co
co
co
co
co
co
co
co
co
co
"}
(28,1,1) = {"
co
co
co
co
co
co
co
co
co
co
co
co
co
co
co
co
co
co
co
co
co
co
co
co
co
co
co
co
co
co
co
co
co
co
co
co
co
co
co
co
co
co
co
co
co
co
co
co
co
co
co
co
"}
(29,1,1) = {"
co
co
co
co
co
co
co
co
co
co
co
co
co
co
co
co
co
co
co
co
co
co
co
co
co
co
co
co
co
co
co
co
co
co
co
co
co
co
co
co
co
co
co
co
co
co
co
co
co
co
co
co
"}
(30,1,1) = {"
co
co
co
co
co
co
co
co
co
co
co
co
co
co
co
co
co
co
co
co
co
co
co
co
co
co
co
co
co
co
co
co
co
co
co
co
co
co
co
co
co
co
co
co
co
co
co
co
co
co
co
co
"}
(31,1,1) = {"
co
co
co
co
co
co
co
co
co
co
co
co
co
co
co
co
co
co
co
co
co
co
co
co
co
co
co
co
co
co
co
co
co
co
co
co
co
co
co
co
co
co
co
co
co
co
co
co
co
co
co
co
"}
(32,1,1) = {"
co
co
co
co
co
co
co
co
co
co
co
co
co
co
co
co
co
co
co
co
co
co
co
co
co
co
co
co
co
co
co
co
co
co
co
co
co
co
co
co
co
co
co
co
co
co
co
co
co
co
co
co
"}
(33,1,1) = {"
co
co
co
co
co
co
co
co
co
co
co
co
co
co
co
co
co
co
co
co
co
co
co
co
co
co
co
co
co
co
co
co
co
co
co
co
co
co
co
co
co
co
co
co
co
co
co
co
co
co
co
co
"}
(34,1,1) = {"
co
co
co
co
co
co
co
co
co
co
co
co
co
co
co
co
co
co
co
co
co
co
co
co
co
co
co
co
co
co
co
co
co
co
co
co
co
co
co
co
co
co
co
co
co
co
co
co
co
co
co
co
"}
(35,1,1) = {"
co
co
co
co
co
co
co
co
co
co
co
co
co
co
co
co
co
co
co
co
co
co
co
co
co
co
co
co
co
co
co
co
co
co
co
co
co
co
co
co
co
co
co
co
co
co
co
co
co
co
co
co
"}
(36,1,1) = {"
co
co
co
co
co
co
co
co
co
co
co
co
co
co
co
co
co
co
co
co
co
co
co
co
co
co
co
co
co
co
co
co
co
co
co
co
co
co
co
co
co
co
co
co
co
co
co
co
co
co
co
co
"}
(37,1,1) = {"
co
co
co
co
co
co
co
co
co
co
co
co
co
co
co
co
co
co
co
co
co
co
co
co
co
co
co
co
co
co
co
co
co
co
co
co
co
co
co
co
co
co
co
co
co
co
co
co
co
co
co
co
"}
(38,1,1) = {"
co
co
co
co
co
co
co
co
co
co
co
co
co
co
co
co
co
co
co
co
co
co
co
co
co
co
co
co
co
co
co
co
co
co
co
co
co
co
co
co
co
co
co
co
co
co
co
co
co
co
co
co
"}
(39,1,1) = {"
co
co
co
co
co
co
co
co
co
co
co
co
co
co
co
co
co
co
co
co
co
co
co
co
co
co
co
co
co
co
co
co
co
co
co
co
co
co
co
co
co
co
co
co
co
co
co
co
co
co
co
co
"}
(40,1,1) = {"
co
co
co
co
co
co
co
co
co
co
co
co
co
co
co
co
co
co
co
co
co
co
co
co
co
co
co
co
co
co
co
co
co
co
co
co
co
co
co
co
co
co
co
co
co
co
co
co
co
co
co
co
"}
(41,1,1) = {"
co
co
co
co
co
co
co
co
co
co
co
co
co
co
co
co
co
co
co
co
co
co
co
co
co
co
co
co
co
co
co
co
co
co
co
co
co
co
co
co
co
co
co
co
co
co
co
co
co
co
co
co
"}
(42,1,1) = {"
co
co
co
co
co
co
co
co
co
co
co
co
co
co
co
co
co
co
co
co
co
co
co
co
co
co
co
co
co
co
co
co
co
co
co
co
co
co
co
co
co
co
co
co
co
co
co
co
co
co
co
co
"}
(43,1,1) = {"
co
co
co
co
co
co
co
co
co
co
co
co
co
co
co
co
co
co
co
co
co
co
co
co
co
co
co
co
co
co
co
co
co
co
co
co
co
co
co
co
co
co
co
co
co
co
co
co
co
co
co
co
"}
(44,1,1) = {"
co
co
co
co
co
co
co
co
co
co
co
co
co
co
co
co
co
co
co
co
co
co
co
co
co
co
co
co
co
co
co
co
co
co
co
co
co
co
co
co
co
co
co
co
co
co
co
co
co
co
co
co
"}
(45,1,1) = {"
co
co
co
co
co
co
co
co
co
co
co
co
co
co
co
co
co
co
co
co
co
co
co
co
co
co
co
co
co
co
co
co
co
co
co
co
co
co
co
co
co
co
co
co
co
co
co
co
co
co
co
co
"}
(46,1,1) = {"
co
co
co
co
co
co
co
co
co
co
co
co
co
co
co
co
co
co
co
co
co
co
co
co
co
co
co
co
co
co
co
co
co
co
co
co
co
co
co
co
co
co
co
co
co
co
co
co
co
co
co
co
"}
(47,1,1) = {"
co
co
co
co
co
co
co
co
co
co
co
co
co
co
co
co
co
co
co
co
co
co
co
co
co
co
co
co
co
co
co
co
co
co
co
co
co
co
co
co
co
co
co
co
co
co
co
co
co
co
co
co
"}
(48,1,1) = {"
co
co
co
co
co
co
co
co
co
co
co
co
co
co
co
co
co
co
co
co
co
co
co
co
co
co
co
co
co
co
co
co
co
co
co
co
co
co
co
co
co
co
co
co
co
co
co
co
co
co
co
co
"}
(49,1,1) = {"
co
co
co
co
co
co
co
co
co
co
co
co
co
co
co
co
co
co
co
co
co
co
co
co
co
co
co
co
co
co
co
co
co
co
co
co
co
co
co
co
co
co
co
co
co
co
co
co
co
co
co
co
"}
(50,1,1) = {"
co
co
co
co
co
co
co
co
co
co
co
co
co
co
co
co
co
co
co
co
co
co
co
co
co
co
co
co
co
co
co
co
co
co
co
co
co
co
co
co
co
co
co
co
co
co
co
co
co
co
co
co
"}
(51,1,1) = {"
co
co
co
co
co
co
co
co
co
co
co
co
co
co
co
co
co
co
co
co
co
co
co
co
co
co
co
co
co
co
co
co
co
co
co
co
co
co
co
co
co
co
co
co
co
co
co
co
co
co
co
co
"}
(52,1,1) = {"
co
co
co
co
co
co
co
co
co
co
co
co
co
co
co
co
co
co
co
co
co
co
co
co
co
co
co
co
co
co
co
co
co
co
co
co
co
co
co
co
co
co
co
co
co
co
co
co
co
co
co
co
"}
