//MAP CONVERTED BY dmm2tgm.py THIS HEADER COMMENT PREVENTS RECONVERSION, DO NOT REMOVE
"aL" = (
/obj/abstract/landmark/start,
/turf/simulated/floor/tiled/dark,
/area/hallway)
"ck" = (
/obj/machinery/blood_analysis{
	pixel_x = 3;
	pixel_y = 9
	},
/obj/structure/table/steel_reinforced,
/turf/simulated/floor/tiled/monotile,
/area/hallway)
"co" = (
/obj/structure/table/steel_reinforced,
/obj/machinery/cardiac_monitor,
/turf/simulated/floor/tiled/monotile,
/area/hallway)
"du" = (
/obj/structure/table/steel_reinforced,
/obj/item/gun/projectile/automatic/assault_rifle,
/obj/machinery/light/spot{
	dir = 4
	},
/turf/simulated/floor/tiled/monotile,
/area/hallway)
"dE" = (
/obj/machinery/optable,
/turf/simulated/floor/tiled/monotile,
/area/hallway)
"fa" = (
/obj/machinery/centrifuge,
/obj/structure/table/steel_reinforced,
/turf/simulated/floor/tiled/monotile,
/area/hallway)
"gT" = (
/obj/item/chems/glass/beaker/vial,
/obj/item/chems/glass/beaker/vial,
/obj/item/chems/glass/beaker/vial,
/obj/item/chems/glass/beaker/vial,
/obj/item/chems/glass/beaker/vial,
/obj/item/chems/glass/beaker/vial,
/obj/item/chems/glass/beaker/vial,
/obj/structure/rack,
/turf/simulated/floor/tiled/monotile,
/area/hallway)
"he" = (
/obj/structure/bed,
/turf/simulated/floor/tiled/monotile,
/area/hallway)
"jB" = (
/obj/structure/table/steel_reinforced,
/obj/item/gun/projectile/automatic/assault_rifle,
/turf/simulated/floor/tiled/monotile,
/area/hallway)
"kw" = (
/obj/machinery/smartfridge/secure/medbay/stocked/blood{
	pixel_y = 32
	},
/turf/simulated/floor/tiled/monotile,
/area/hallway)
"la" = (
/obj/structure/window/reinforced/full,
/turf/simulated/floor/tiled/monotile,
/area/hallway)
"lN" = (
/obj/machinery/light/spot,
/turf/simulated/floor/tiled/monotile,
/area/hallway)
"mc" = (
/obj/structure/rack,
/obj/item/chems/syringe,
/obj/item/chems/syringe,
/obj/item/chems/syringe,
/obj/item/chems/syringe,
/obj/item/chems/syringe,
/obj/item/chems/syringe,
/turf/simulated/floor/tiled/monotile,
/area/hallway)
"nL" = (
/obj/structure/rack,
/obj/item/stack/medical/wound_filler/hydrofiber,
/obj/item/stack/medical/wound_filler/hydrofiber,
/obj/item/stack/medical/wound_filler/hydrofiber,
/obj/item/stack/medical/wound_filler/hydrofiber,
/obj/item/stack/medical/wound_filler/hydrofiber,
/obj/item/stack/medical/wound_filler/hydrofiber,
/obj/item/stack/medical/wound_filler/hydrofiber,
/obj/item/stack/medical/wound_filler/hydrofiber,
/obj/item/stack/medical/wound_filler/hydrofiber,
/obj/item/stack/medical/wound_filler/hydrofiber,
/turf/simulated/floor/tiled/monotile,
/area/hallway)
"ou" = (
/mob/living/carbon/human{
	teleop = "aboba"
	},
/turf/simulated/floor/tiled/monotile,
/area/hallway)
"oB" = (
/obj/structure/table/steel_reinforced,
/obj/item/gun/projectile/pistol/military_service,
/turf/simulated/floor/tiled/monotile,
/area/hallway)
"oZ" = (
/obj/structure/table/steel_reinforced,
/obj/item/ammo_magazine/pistol,
/obj/item/ammo_magazine/pistol,
/obj/item/ammo_magazine/pistol,
/obj/item/ammo_magazine/pistol,
/obj/item/ammo_magazine/pistol,
/obj/item/ammo_magazine/pistol,
/obj/item/ammo_magazine/pistol,
/obj/item/ammo_magazine/pistol,
/obj/item/ammo_magazine/pistol,
/obj/item/ammo_magazine/pistol,
/obj/item/ammo_magazine/pistol,
/turf/simulated/floor/tiled/monotile,
/area/hallway)
"rg" = (
/obj/structure/rack,
/obj/item/thermometer,
/obj/item/thermometer,
/obj/item/thermometer,
/turf/simulated/floor/tiled/monotile,
/area/hallway)
"rH" = (
/obj/structure/table/steel_reinforced,
/obj/item/storage/box/ammo/shotgunshells,
/obj/item/storage/box/ammo/shotgunshells,
/obj/item/storage/box/ammo/shotgunshells,
/obj/item/storage/box/ammo/shotgunammo,
/obj/item/storage/box/ammo/shotgunammo,
/obj/item/storage/box/ammo/shotgunammo,
/turf/simulated/floor/tiled/monotile,
/area/hallway)
"sT" = (
/obj/structure/rack,
/obj/item/intubation_bag,
/obj/item/intubation_bag,
/obj/item/intubation_bag,
/obj/item/intubation_bag,
/obj/machinery/light/spot{
	dir = 8
	},
/obj/item/chest_tube,
/obj/item/chest_tube,
/obj/item/chest_tube,
/obj/item/chest_tube,
/turf/simulated/floor/tiled/monotile,
/area/hallway)
"tl" = (
/obj/machinery/power/apc/hyper{
	dir = 1;
	pixel_y = 21
	},
/obj/structure/cable{
	icon_state = "0-8"
	},
/turf/simulated/floor/tiled/monotile,
/area/hallway)
"vZ" = (
/mob/living/carbon/human{
	teleop = "aboba"
	},
/obj/machinery/light/spot{
	dir = 4
	},
/turf/simulated/floor/tiled/monotile,
/area/hallway)
"wj" = (
/obj/structure/bed/roller/hydraulic,
/turf/simulated/floor/tiled/monotile,
/area/hallway)
"wP" = (
/obj/structure/rack,
/obj/item/defibrillator/loaded,
/obj/item/defibrillator/loaded,
/obj/item/defibrillator/loaded,
/turf/simulated/floor/tiled/monotile,
/area/hallway)
"xq" = (
/obj/abstract/level_data_spawner/main_level,
/turf/simulated/wall/r_wall,
/area/hallway)
"Bs" = (
/turf/simulated/floor/tiled/monotile,
/area/hallway)
"CO" = (
/obj/machinery/power/debug_items/infinite_cable_powersink,
/obj/structure/cable{
	icon_state = "0-4"
	},
/turf/simulated/floor/tiled/monotile,
/area/hallway)
"DA" = (
/obj/structure/table/steel_reinforced,
/obj/item/ammo_magazine/rifle,
/obj/item/ammo_magazine/rifle,
/obj/item/ammo_magazine/rifle,
/obj/item/ammo_magazine/rifle,
/obj/item/ammo_magazine/rifle,
/obj/item/ammo_magazine/rifle,
/obj/item/ammo_magazine/rifle,
/turf/simulated/floor/tiled/monotile,
/area/hallway)
"Ed" = (
/obj/structure/target_stake,
/obj/item/target,
/turf/simulated/floor/tiled/monotile,
/area/hallway)
"EM" = (
/turf/simulated/wall/r_wall,
/area/hallway)
"Hk" = (
/obj/structure/table/steel_reinforced,
/obj/item/storage/firstaid/surgery,
/turf/simulated/floor/tiled/monotile,
/area/hallway)
"JH" = (
/obj/structure/table/steel_reinforced,
/obj/machinery/cardiac_monitor,
/obj/machinery/light/spot{
	dir = 4
	},
/turf/simulated/floor/tiled/monotile,
/area/hallway)
"JS" = (
/obj/abstract/landmark/latejoin,
/turf/simulated/floor/tiled/dark,
/area/hallway)
"KJ" = (
/obj/structure/rack,
/obj/item/stack/medical/ointment,
/obj/item/stack/medical/ointment,
/obj/item/stack/medical/ointment,
/obj/item/stack/medical/ointment,
/obj/item/stack/medical/ointment,
/obj/item/stack/medical/ointment,
/obj/item/stack/medical/ointment,
/turf/simulated/floor/tiled/monotile,
/area/hallway)
"La" = (
/obj/machinery/lung_ventilator,
/obj/machinery/light/spot{
	dir = 4
	},
/turf/simulated/floor/tiled/monotile,
/area/hallway)
"OI" = (
/obj/structure/rack,
/obj/item/stack/medical/bruise_pack,
/obj/item/stack/medical/bruise_pack,
/obj/item/stack/medical/bruise_pack,
/obj/item/stack/medical/bruise_pack,
/obj/item/stack/medical/bruise_pack,
/obj/item/stack/medical/bruise_pack,
/obj/item/stack/medical/bruise_pack,
/turf/simulated/floor/tiled/monotile,
/area/hallway)
"Qc" = (
/obj/machinery/smartfridge/secure/medbay/stocked{
	pixel_y = 32
	},
/turf/simulated/floor/tiled/monotile,
/area/hallway)
"RF" = (
/obj/structure/cable{
	dir = 4
	},
/turf/simulated/floor/tiled/monotile,
/area/hallway)
"RV" = (
/obj/machinery/lung_ventilator,
/obj/machinery/light/spot{
	dir = 8
	},
/turf/simulated/floor/tiled/monotile,
/area/hallway)
"Sv" = (
/obj/machinery/light/spot{
	dir = 1
	},
/turf/simulated/floor/tiled/monotile,
/area/hallway)
"Ts" = (
/obj/machinery/light/spot{
	dir = 8
	},
/turf/simulated/floor/tiled/monotile,
/area/hallway)
"UH" = (
/obj/machinery/light/spot,
/obj/abstract/landmark/latejoin,
/turf/simulated/floor/tiled/dark,
/area/hallway)
"Wj" = (
/obj/structure/table/steel_reinforced,
/obj/item/gun/projectile/shotgun/pump,
/turf/simulated/floor/tiled/monotile,
/area/hallway)
"WF" = (
/turf/simulated/floor/tiled/dark,
/area/hallway)
"WW" = (
/obj/structure/rack,
/obj/item/stack/medical/splint,
/obj/item/stack/medical/splint,
/obj/item/stack/medical/splint,
/obj/item/stack/medical/splint,
/obj/item/stack/medical/splint,
/obj/item/stack/medical/splint,
/obj/item/stack/medical/splint,
/turf/simulated/floor/tiled/monotile,
/area/hallway)

(1,1,1) = {"
EM
EM
EM
EM
EM
EM
EM
EM
EM
EM
EM
EM
EM
EM
EM
EM
EM
EM
EM
EM
EM
EM
EM
EM
EM
EM
EM
EM
EM
EM
EM
EM
EM
EM
EM
EM
EM
EM
EM
EM
EM
EM
EM
EM
EM
EM
EM
EM
EM
EM
EM
xq
"}
(2,1,1) = {"
EM
Bs
Bs
Bs
Bs
Bs
Bs
Bs
Bs
Bs
Bs
Bs
Bs
Bs
Bs
Bs
Bs
Bs
Bs
Bs
Bs
Bs
Bs
Bs
Bs
Bs
Bs
Bs
Bs
Bs
Bs
Bs
Bs
EM
Ed
ou
Bs
Bs
Ts
Bs
oB
Bs
Bs
Bs
EM
EM
EM
EM
EM
EM
EM
EM
"}
(3,1,1) = {"
EM
Bs
Bs
Bs
Bs
Bs
Bs
Bs
Bs
Bs
Bs
Bs
Bs
Bs
Bs
Bs
Bs
Bs
Bs
Bs
Bs
Bs
Bs
Bs
Bs
Bs
Bs
Bs
Bs
Bs
Bs
Bs
Bs
EM
Ed
ou
Bs
Bs
Bs
Bs
oZ
Bs
Bs
Bs
EM
aL
aL
aL
aL
aL
EM
EM
"}
(4,1,1) = {"
EM
Bs
Bs
Bs
Bs
Bs
Bs
Bs
Bs
Bs
Bs
Bs
Bs
Bs
Bs
Bs
Bs
Bs
Bs
Bs
Bs
Bs
Bs
Bs
Bs
Bs
Bs
Bs
Bs
Bs
Bs
Bs
Bs
EM
Ed
ou
Bs
Bs
Bs
Bs
oB
Bs
Bs
Bs
EM
JS
JS
JS
JS
JS
EM
EM
"}
(5,1,1) = {"
EM
Bs
Bs
Bs
Bs
Bs
Bs
Bs
Bs
Bs
Bs
Bs
Bs
Bs
Bs
Bs
Bs
Bs
Bs
Bs
Bs
Bs
Bs
Bs
Bs
Bs
Bs
Bs
Bs
Bs
Bs
Bs
Bs
EM
Sv
Bs
Bs
Bs
Bs
la
la
Bs
Bs
lN
EM
aL
aL
aL
aL
aL
EM
EM
"}
(6,1,1) = {"
EM
Bs
Bs
Bs
Bs
Bs
Bs
Bs
Bs
Bs
Bs
Bs
Bs
Bs
Bs
Bs
Bs
Bs
Bs
Bs
Bs
Bs
Bs
Bs
Bs
Bs
Bs
Bs
Bs
Bs
Bs
Bs
Bs
EM
Ed
ou
Bs
Bs
Bs
Wj
Bs
Bs
Bs
Bs
EM
JS
JS
JS
JS
UH
EM
EM
"}
(7,1,1) = {"
EM
Bs
Bs
Bs
Bs
Bs
Bs
Bs
Bs
Bs
Bs
Bs
Bs
Bs
Bs
Bs
Bs
Bs
Bs
Bs
Bs
Bs
Bs
Bs
Bs
Bs
Bs
Bs
Bs
Bs
Bs
Bs
Bs
EM
Ed
ou
Bs
Bs
Bs
rH
Bs
Bs
Bs
Bs
EM
WF
WF
WF
WF
WF
EM
EM
"}
(8,1,1) = {"
EM
Bs
Bs
Bs
Bs
Bs
Bs
Bs
Bs
Bs
Bs
Bs
Bs
Bs
Bs
Bs
Bs
Bs
Bs
Bs
Bs
Bs
Bs
Bs
Bs
Bs
Bs
Bs
Bs
Bs
Bs
Bs
Bs
EM
Ed
ou
Bs
Bs
Bs
Wj
Bs
Bs
Bs
Bs
WF
WF
WF
WF
WF
WF
EM
EM
"}
(9,1,1) = {"
EM
Bs
Bs
Bs
Bs
Bs
Bs
Bs
Bs
Bs
Bs
Bs
Bs
Bs
Bs
Bs
Bs
Bs
Bs
Bs
Bs
Bs
Bs
Bs
Bs
Bs
Bs
Bs
Bs
Bs
Bs
Bs
Bs
EM
Sv
Bs
Bs
Bs
la
la
Bs
Bs
Bs
lN
EM
WF
WF
WF
WF
WF
EM
EM
"}
(10,1,1) = {"
EM
Bs
Bs
Bs
Bs
Bs
Bs
Bs
Bs
Bs
Bs
Bs
Bs
Bs
Bs
Bs
Bs
Bs
Bs
Bs
Bs
Bs
Bs
Bs
Bs
Bs
Bs
Bs
Bs
Bs
Bs
Bs
Bs
EM
Ed
ou
Bs
Bs
jB
Bs
Bs
Bs
Bs
Bs
EM
EM
EM
EM
EM
EM
EM
EM
"}
(11,1,1) = {"
EM
Bs
Bs
Bs
Bs
Bs
Bs
Bs
Bs
Bs
Bs
Bs
Bs
Bs
Bs
Bs
Bs
Bs
Bs
Bs
Bs
Bs
Bs
Bs
Bs
Bs
Bs
Bs
Bs
Bs
Bs
Bs
Bs
EM
Ed
ou
Bs
Bs
DA
Bs
Bs
Bs
Bs
Bs
sT
Bs
WW
wj
wj
Bs
RV
EM
"}
(12,1,1) = {"
EM
Bs
Bs
Bs
Bs
Bs
Bs
Bs
Bs
Bs
Bs
Bs
Bs
Bs
Bs
Bs
Bs
Bs
Bs
Bs
Bs
Bs
Bs
Bs
Bs
Bs
Bs
Bs
Bs
Bs
Bs
Bs
Bs
EM
Ed
ou
Bs
Bs
du
Bs
Bs
Bs
Bs
Bs
rg
Bs
KJ
Bs
Bs
Bs
dE
EM
"}
(13,1,1) = {"
EM
Bs
Bs
Bs
Bs
Bs
Bs
Bs
Bs
Bs
Bs
Bs
Bs
Bs
Bs
Bs
Bs
Bs
Bs
Bs
Bs
Bs
Bs
Bs
Bs
Bs
Bs
Bs
Bs
Bs
Bs
Bs
Bs
EM
EM
EM
EM
EM
EM
Bs
Bs
EM
Qc
Bs
wP
Bs
nL
Bs
Bs
Bs
Hk
EM
"}
(14,1,1) = {"
EM
Bs
Bs
Bs
Bs
Bs
Bs
Bs
Bs
Bs
Bs
Bs
Bs
Bs
Bs
Bs
Bs
Bs
Bs
Bs
Bs
Bs
Bs
Bs
Bs
Bs
Bs
Bs
Bs
Bs
Bs
Bs
Bs
EM
CO
Ts
Bs
Bs
Bs
Bs
Bs
EM
Qc
Bs
mc
Bs
OI
gT
Bs
Bs
la
EM
"}
(15,1,1) = {"
EM
Bs
Bs
Bs
Bs
Bs
Bs
Bs
Bs
Bs
Bs
Bs
Bs
Bs
Bs
Bs
Bs
Bs
Bs
Bs
Bs
Bs
Bs
Bs
Bs
Bs
Bs
Bs
Bs
Bs
Bs
Bs
Bs
EM
tl
Bs
Bs
Bs
Bs
Bs
Bs
EM
kw
Bs
Bs
Bs
Bs
Bs
Bs
Bs
Hk
EM
"}
(16,1,1) = {"
EM
Bs
Bs
Bs
Bs
Bs
Bs
Bs
Bs
Bs
Bs
Bs
Bs
Bs
Bs
Bs
Bs
Bs
Bs
Bs
Bs
Bs
Bs
Bs
Bs
Bs
Bs
Bs
Bs
Bs
Bs
Bs
Bs
EM
Bs
Bs
Bs
Bs
Bs
Bs
Bs
EM
kw
Bs
Bs
Bs
Bs
Bs
Bs
Bs
dE
EM
"}
(17,1,1) = {"
EM
Bs
Bs
Bs
Bs
Bs
Bs
Bs
Bs
Bs
Bs
Bs
Bs
Bs
Bs
Bs
Bs
Bs
Bs
Bs
Bs
Bs
Bs
Bs
Bs
Bs
Bs
Bs
Bs
Bs
Bs
Bs
Bs
Bs
Bs
Bs
Bs
Bs
Bs
Bs
Bs
EM
Bs
he
JH
he
co
fa
ck
Bs
La
EM
"}
(18,1,1) = {"
EM
Bs
Bs
Bs
Bs
Bs
Bs
Bs
Bs
Bs
Bs
Bs
Bs
Bs
Bs
Bs
Bs
Bs
Bs
Bs
Bs
Bs
Bs
Bs
Bs
Bs
Bs
Bs
Bs
Bs
Bs
Bs
Bs
Bs
Bs
Bs
Bs
Bs
Bs
Bs
Bs
EM
Bs
EM
EM
EM
EM
EM
EM
EM
EM
EM
"}
(19,1,1) = {"
EM
Bs
Bs
Bs
Bs
Bs
Bs
Bs
Bs
Bs
Bs
Bs
Bs
Bs
Bs
Bs
Bs
Bs
Bs
Bs
Bs
Bs
Bs
Bs
Bs
Bs
Bs
Bs
Bs
Bs
Bs
Bs
Bs
Bs
Bs
Bs
Bs
Bs
Bs
Bs
Bs
EM
ou
ou
ou
ou
EM
Bs
Bs
Bs
Bs
EM
"}
(20,1,1) = {"
EM
Bs
Bs
Bs
Bs
Bs
Bs
Bs
Bs
Bs
Bs
Bs
Bs
Bs
Bs
Bs
Bs
Bs
Bs
Bs
Bs
Bs
Bs
Bs
Bs
Bs
Bs
Bs
Bs
Bs
Bs
Bs
Bs
Bs
Bs
Bs
Bs
Bs
Bs
Bs
Bs
EM
ou
ou
ou
ou
EM
Bs
Bs
Bs
Bs
EM
"}
(21,1,1) = {"
EM
Bs
Bs
Bs
Bs
Bs
Bs
Bs
Bs
Bs
Bs
Bs
Bs
Bs
Bs
Bs
Bs
Bs
Bs
Bs
Bs
Bs
Bs
Bs
Bs
Bs
Bs
Bs
Bs
Bs
Bs
Bs
Bs
Bs
Bs
Bs
Bs
Bs
Bs
Bs
Bs
EM
ou
ou
vZ
ou
EM
Bs
Bs
Bs
Bs
EM
"}
(22,1,1) = {"
EM
Bs
Bs
Bs
Bs
Bs
Bs
Bs
Bs
Bs
Bs
Bs
Bs
Bs
Bs
Bs
Bs
Bs
Bs
Bs
Bs
Bs
Bs
Bs
Bs
Bs
Bs
Bs
Bs
Bs
Bs
Bs
Bs
Bs
Bs
Bs
Bs
Bs
Bs
Bs
lN
EM
EM
EM
EM
EM
EM
Bs
Bs
Bs
Bs
EM
"}
(23,1,1) = {"
EM
Bs
Bs
Bs
Bs
Bs
Bs
Bs
Bs
Bs
Bs
Bs
Bs
Bs
Bs
Bs
Bs
Bs
Bs
Bs
Bs
Bs
Bs
Bs
Bs
Bs
Bs
Bs
Bs
Bs
Bs
Bs
Bs
Bs
Bs
Bs
Bs
Bs
Bs
Bs
Bs
Bs
Bs
Bs
Bs
Bs
Bs
Bs
Bs
Bs
Bs
EM
"}
(24,1,1) = {"
EM
Bs
Bs
Bs
Bs
Bs
Bs
Bs
Bs
Bs
Bs
Bs
Bs
Bs
Bs
Bs
Bs
Bs
Bs
Bs
Bs
Bs
Bs
Bs
Bs
Bs
Bs
Bs
Bs
Bs
Bs
Bs
Bs
Bs
Bs
Bs
Bs
Bs
Bs
Bs
Bs
Bs
Bs
Bs
Bs
Bs
Bs
Bs
Bs
Bs
Bs
EM
"}
(25,1,1) = {"
EM
Bs
Bs
Bs
Bs
Bs
Bs
Bs
Bs
Bs
Bs
Bs
Bs
Bs
Bs
Bs
Bs
Bs
Bs
Bs
Bs
Bs
Bs
Bs
Bs
Bs
Bs
Bs
Bs
Bs
Bs
Bs
Bs
Bs
Bs
Bs
Bs
Bs
Bs
Bs
Bs
Bs
Bs
Bs
Bs
Bs
Bs
Bs
Bs
Bs
Bs
EM
"}
(26,1,1) = {"
EM
Bs
Bs
Bs
Bs
Bs
Bs
Bs
Bs
Bs
Bs
Bs
Bs
Bs
Bs
Bs
Bs
Bs
Bs
Bs
Bs
Bs
Bs
Bs
Bs
Bs
Bs
Bs
Bs
Bs
Bs
Bs
Bs
Bs
Bs
Bs
Bs
Bs
Bs
Bs
Bs
Bs
Bs
Bs
Bs
Bs
Bs
Bs
Bs
Bs
Bs
EM
"}
(27,1,1) = {"
EM
Bs
Bs
Bs
Bs
Bs
Bs
Bs
Bs
Bs
Bs
Bs
Bs
Bs
Bs
Bs
Bs
Bs
Bs
Bs
Bs
Bs
Bs
Bs
Bs
Bs
Bs
Bs
Bs
Bs
Bs
Bs
Bs
Bs
Bs
Bs
Bs
Bs
Bs
Bs
Bs
Bs
Bs
Bs
Bs
Bs
Bs
Bs
Bs
Bs
Bs
EM
"}
(28,1,1) = {"
EM
Bs
Bs
Bs
Bs
Bs
Bs
Bs
Bs
Bs
Bs
Bs
Bs
Bs
Bs
Bs
Bs
Bs
Bs
Bs
Bs
Bs
Bs
Bs
Bs
Bs
Bs
Bs
Bs
Bs
Bs
Bs
Bs
Bs
Bs
Bs
Bs
Bs
Bs
Bs
Bs
Bs
Bs
Bs
Bs
Bs
Bs
Bs
Bs
Bs
Bs
EM
"}
(29,1,1) = {"
EM
Bs
Bs
Bs
Bs
Bs
Bs
Bs
Bs
Bs
Bs
Bs
Bs
Bs
Bs
Bs
Bs
Bs
Bs
Bs
Bs
Bs
Bs
Bs
Bs
Bs
Bs
Bs
Bs
Bs
Bs
Bs
Bs
Bs
Bs
Bs
RF
Bs
Bs
Bs
Bs
Bs
Bs
Bs
Bs
Bs
Bs
Bs
Bs
Bs
Bs
EM
"}
(30,1,1) = {"
EM
Bs
Bs
Bs
Bs
Bs
Bs
Bs
Bs
Bs
Bs
Bs
Bs
Bs
Bs
Bs
Bs
Bs
Bs
Bs
Bs
Bs
Bs
Bs
Bs
Bs
Bs
Bs
Bs
Bs
Bs
Bs
Bs
Bs
Bs
Bs
Bs
Bs
Bs
Bs
Bs
Bs
Bs
Bs
Bs
Bs
Bs
Bs
Bs
Bs
Bs
EM
"}
(31,1,1) = {"
EM
Bs
Bs
Bs
Bs
Bs
Bs
Bs
Bs
Bs
Bs
Bs
Bs
Bs
Bs
Bs
Bs
Bs
Bs
Bs
Bs
Bs
Bs
Bs
Bs
Bs
Bs
Bs
Bs
Bs
Bs
Bs
Bs
Bs
Bs
Bs
Bs
Bs
Bs
Bs
Bs
Bs
Bs
Bs
Bs
Bs
Bs
Bs
Bs
Bs
Bs
EM
"}
(32,1,1) = {"
EM
Bs
Bs
Bs
Bs
Bs
Bs
Bs
Bs
Bs
Bs
Bs
Bs
Bs
Bs
Bs
Bs
Bs
Bs
Bs
Bs
Bs
Bs
Bs
Bs
Bs
Bs
Bs
Bs
Bs
Bs
Bs
Bs
Bs
Bs
Bs
Bs
Bs
Bs
Bs
Bs
Bs
Bs
Bs
Bs
Bs
Bs
Bs
Bs
Bs
Bs
EM
"}
(33,1,1) = {"
EM
Bs
Bs
Bs
Bs
Bs
Bs
Bs
Bs
Bs
Bs
Bs
Bs
Bs
Bs
Bs
Bs
Bs
Bs
Bs
Bs
Bs
Bs
Bs
Bs
Bs
Bs
Bs
Bs
Bs
Bs
Bs
Bs
Bs
Bs
Bs
Bs
Bs
Bs
Bs
Bs
Bs
Bs
Bs
Bs
Bs
Bs
Bs
Bs
Bs
Bs
EM
"}
(34,1,1) = {"
EM
Bs
Bs
Bs
Bs
Bs
Bs
Bs
Bs
Bs
Bs
Bs
Bs
Bs
Bs
Bs
Bs
Bs
Bs
Bs
Bs
Bs
Bs
Bs
Bs
Bs
Bs
Bs
Bs
Bs
Bs
Bs
Bs
Bs
Bs
Bs
Bs
Bs
Bs
Bs
Bs
Bs
Bs
Bs
Bs
Bs
Bs
Bs
Bs
Bs
Bs
EM
"}
(35,1,1) = {"
EM
Bs
Bs
Bs
Bs
Bs
Bs
Bs
Bs
Bs
Bs
Bs
Bs
Bs
Bs
Bs
Bs
Bs
Bs
Bs
Bs
Bs
Bs
Bs
Bs
Bs
Bs
Bs
Bs
Bs
Bs
Bs
Bs
Bs
Bs
Bs
Bs
Bs
Bs
Bs
Bs
Bs
Bs
Bs
Bs
Bs
Bs
Bs
Bs
Bs
Bs
EM
"}
(36,1,1) = {"
EM
Bs
Bs
Bs
Bs
Bs
Bs
Bs
Bs
Bs
Bs
Bs
Bs
Bs
Bs
Bs
Bs
Bs
Bs
Bs
Bs
Bs
Bs
Bs
Bs
Bs
Bs
Bs
Bs
Bs
Bs
Bs
Bs
Bs
Bs
Bs
Bs
Bs
Bs
Bs
Bs
Bs
Bs
Bs
Bs
Bs
Bs
Bs
Bs
Bs
Bs
EM
"}
(37,1,1) = {"
EM
Bs
Bs
Bs
Bs
Bs
Bs
Bs
Bs
Bs
Bs
Bs
Bs
Bs
Bs
Bs
Bs
Bs
Bs
Bs
Bs
Bs
Bs
Bs
Bs
Bs
Bs
Bs
Bs
Bs
Bs
Bs
Bs
Bs
Bs
Bs
Bs
Bs
Bs
Bs
Bs
Bs
Bs
Bs
Bs
Bs
Bs
Bs
Bs
Bs
Bs
EM
"}
(38,1,1) = {"
EM
Bs
Bs
Bs
Bs
Bs
Bs
Bs
Bs
Bs
Bs
Bs
Bs
Bs
Bs
Bs
Bs
Bs
Bs
Bs
Bs
Bs
Bs
Bs
Bs
Bs
Bs
Bs
Bs
Bs
Bs
Bs
Bs
Bs
Bs
Bs
Bs
Bs
Bs
Bs
Bs
Bs
Bs
Bs
Bs
Bs
Bs
Bs
Bs
Bs
Bs
EM
"}
(39,1,1) = {"
EM
Bs
Bs
Bs
Bs
Bs
Bs
Bs
Bs
Bs
Bs
Bs
Bs
Bs
Bs
Bs
Bs
Bs
Bs
Bs
Bs
Bs
Bs
Bs
Bs
Bs
Bs
Bs
Bs
Bs
Bs
Bs
Bs
Bs
Bs
Bs
Bs
Bs
Bs
Bs
Bs
Bs
Bs
Bs
Bs
Bs
Bs
Bs
Bs
Bs
Bs
EM
"}
(40,1,1) = {"
EM
Bs
Bs
Bs
Bs
Bs
Bs
Bs
Bs
Bs
Bs
Bs
Bs
Bs
Bs
Bs
Bs
Bs
Bs
Bs
Bs
Bs
Bs
Bs
Bs
Bs
Bs
Bs
Bs
Bs
Bs
Bs
Bs
Bs
Bs
Bs
Bs
Bs
Bs
Bs
Bs
Bs
Bs
Bs
Bs
Bs
Bs
Bs
Bs
Bs
Bs
EM
"}
(41,1,1) = {"
EM
Bs
Bs
Bs
Bs
Bs
Bs
Bs
Bs
Bs
Bs
Bs
Bs
Bs
Bs
Bs
Bs
Bs
Bs
Bs
Bs
Bs
Bs
Bs
Bs
Bs
Bs
Bs
Bs
Bs
Bs
Bs
Bs
Bs
Bs
Bs
Bs
Bs
Bs
Bs
Bs
Bs
Bs
Bs
Bs
Bs
Bs
Bs
Bs
Bs
Bs
EM
"}
(42,1,1) = {"
EM
Bs
Bs
Bs
Bs
Bs
Bs
Bs
Bs
Bs
Bs
Bs
Bs
Bs
Bs
Bs
Bs
Bs
Bs
Bs
Bs
Bs
Bs
Bs
Bs
Bs
Bs
Bs
Bs
Bs
Bs
Bs
Bs
Bs
Bs
Bs
Bs
Bs
Bs
Bs
Bs
Bs
Bs
Bs
Bs
Bs
Bs
Bs
Bs
Bs
Bs
EM
"}
(43,1,1) = {"
EM
Bs
Bs
Bs
Bs
Bs
Bs
Bs
Bs
Bs
Bs
Bs
Bs
Bs
Bs
Bs
Bs
Bs
Bs
Bs
Bs
Bs
Bs
Bs
Bs
Bs
Bs
Bs
Bs
Bs
Bs
Bs
Bs
Bs
Bs
Bs
Bs
Bs
Bs
Bs
Bs
Bs
Bs
Bs
Bs
Bs
Bs
Bs
Bs
Bs
Bs
EM
"}
(44,1,1) = {"
EM
Bs
Bs
Bs
Bs
Bs
Bs
Bs
Bs
Bs
Bs
Bs
Bs
Bs
Bs
Bs
Bs
Bs
Bs
Bs
Bs
Bs
Bs
Bs
Bs
Bs
Bs
Bs
Bs
Bs
Bs
Bs
Bs
Bs
Bs
Bs
Bs
Bs
Bs
Bs
Bs
Bs
Bs
Bs
Bs
Bs
Bs
Bs
Bs
Bs
Bs
EM
"}
(45,1,1) = {"
EM
Bs
Bs
Bs
Bs
Bs
Bs
Bs
Bs
Bs
Bs
Bs
Bs
Bs
Bs
Bs
Bs
Bs
Bs
Bs
Bs
Bs
Bs
Bs
Bs
Bs
Bs
Bs
Bs
Bs
Bs
Bs
Bs
Bs
Bs
Bs
Bs
Bs
Bs
Bs
Bs
Bs
Bs
Bs
Bs
Bs
Bs
Bs
Bs
Bs
Bs
EM
"}
(46,1,1) = {"
EM
Bs
Bs
Bs
Bs
Bs
Bs
Bs
Bs
Bs
Bs
Bs
Bs
Bs
Bs
Bs
Bs
Bs
Bs
Bs
Bs
Bs
Bs
Bs
Bs
Bs
Bs
Bs
Bs
Bs
Bs
Bs
Bs
Bs
Bs
Bs
Bs
Bs
Bs
Bs
Bs
Bs
Bs
Bs
Bs
Bs
Bs
Bs
Bs
Bs
Bs
EM
"}
(47,1,1) = {"
EM
Bs
Bs
Bs
Bs
Bs
Bs
Bs
Bs
Bs
Bs
Bs
Bs
Bs
Bs
Bs
Bs
Bs
Bs
Bs
Bs
Bs
Bs
Bs
Bs
Bs
Bs
Bs
Bs
Bs
Bs
Bs
Bs
Bs
Bs
Bs
Bs
Bs
Bs
Bs
Bs
Bs
Bs
Bs
Bs
Bs
Bs
Bs
Bs
Bs
Bs
EM
"}
(48,1,1) = {"
EM
Bs
Bs
Bs
Bs
Bs
Bs
Bs
Bs
Bs
Bs
Bs
Bs
Bs
Bs
Bs
Bs
Bs
Bs
Bs
Bs
Bs
Bs
Bs
Bs
Bs
Bs
Bs
Bs
Bs
Bs
Bs
Bs
Bs
Bs
Bs
Bs
Bs
Bs
Bs
Bs
Bs
Bs
Bs
Bs
Bs
Bs
Bs
Bs
Bs
Bs
EM
"}
(49,1,1) = {"
EM
Bs
Bs
Bs
Bs
Bs
Bs
Bs
Bs
Bs
Bs
Bs
Bs
Bs
Bs
Bs
Bs
Bs
Bs
Bs
Bs
Bs
Bs
Bs
Bs
Bs
Bs
Bs
Bs
Bs
Bs
Bs
Bs
Bs
Bs
Bs
Bs
Bs
Bs
Bs
Bs
Bs
Bs
Bs
Bs
Bs
Bs
Bs
Bs
Bs
Bs
EM
"}
(50,1,1) = {"
EM
Bs
Bs
Bs
Bs
Bs
Bs
Bs
Bs
Bs
Bs
Bs
Bs
Bs
Bs
Bs
Bs
Bs
Bs
Bs
Bs
Bs
Bs
Bs
Bs
Bs
Bs
Bs
Bs
Bs
Bs
Bs
Bs
Bs
Bs
Bs
Bs
Bs
Bs
Bs
Bs
Bs
Bs
Bs
Bs
Bs
Bs
Bs
Bs
Bs
Bs
EM
"}
(51,1,1) = {"
EM
Bs
Bs
Bs
Bs
Bs
Bs
Bs
Bs
Bs
Bs
Bs
Bs
Bs
Bs
Bs
Bs
Bs
Bs
Bs
Bs
Bs
Bs
Bs
Bs
Bs
Bs
Bs
Bs
Bs
Bs
Bs
Bs
Bs
Bs
Bs
Bs
Bs
Bs
Bs
Bs
Bs
Bs
Bs
Bs
Bs
Bs
Bs
Bs
Bs
Bs
EM
"}
(52,1,1) = {"
EM
EM
EM
EM
EM
EM
EM
EM
EM
EM
EM
EM
EM
EM
EM
EM
EM
EM
EM
EM
EM
EM
EM
EM
EM
EM
EM
EM
EM
EM
EM
EM
EM
EM
EM
EM
EM
EM
EM
EM
EM
EM
EM
EM
EM
EM
EM
EM
EM
EM
EM
EM
"}
