"a" = (/obj/machinery/door/airlock/hatch,/obj/modular_map_connector,/turf/simulated/floor/plating,/area/avalon/shelter/engineering)
"c" = (/obj/item/stack/material/rods,/turf/simulated/floor/asteroid,/area/avalon/shelter/engineering)
"e" = (/obj/random/junk,/turf/simulated/floor/plating,/area/avalon/shelter/engineering)
"f" = (/obj/structure/wall_frame/standard,/obj/structure/window/basic/full,/obj/structure/barricade,/turf/simulated/floor/plating,/area/avalon/shelter/engineering)
"h" = (/obj/item/stack/material/rods,/obj/effect/decal/cleanable/dirt,/obj/effect/decal/cleanable/blood/oil/streak,/turf/simulated/floor/plating,/area/avalon/shelter/engineering)
"i" = (/obj/item/stack/tile/floor_dark,/turf/simulated/floor/plating,/area/avalon/shelter/engineering)
"l" = (/obj/effect/decal/cleanable/dirt,/obj/random/junk,/turf/simulated/floor/plating,/area/avalon/shelter/engineering)
"o" = (/turf/simulated/floor/plating,/area/avalon/shelter/engineering)
"q" = (/turf/simulated/floor/asteroid,/area/avalon/shelter/engineering)
"s" = (/turf/exterior/wall,/area/avalon/shelter/engineering)
"t" = (/obj/effect/decal/cleanable/dirt,/obj/item/flashlight/lamp/floodlamp{dir = 4},/obj/effect/decal/cleanable/blood/oil,/turf/simulated/floor/plating,/area/avalon/shelter/engineering)
"u" = (/obj/effect/decal/cleanable/dirt,/obj/item/flashlight/lamp/floodlamp{dir = 1},/turf/simulated/floor/plating,/area/avalon/shelter/engineering)
"z" = (/obj/structure/inflatable/wall,/turf/simulated/floor/plating,/area/avalon/shelter/engineering)
"A" = (/obj/effect/decal/cleanable/dirt,/obj/effect/decal/cleanable/blood/oil/streak,/turf/simulated/floor/plating,/area/avalon/shelter/engineering)
"B" = (/obj/structure/boulder,/obj/effect/decal/cleanable/dirt,/obj/effect/decal/cleanable/dirt,/turf/simulated/floor/asteroid,/area/avalon/shelter/engineering)
"C" = (/obj/machinery/door/airlock/hatch{locked = 1},/turf/simulated/floor/plating,/area/avalon/shelter/engineering)
"D" = (/obj/structure/wall_frame/standard,/obj/structure/window/basic/full,/turf/simulated/floor/plating,/area/avalon/shelter/engineering)
"H" = (/obj/structure/wall_frame/standard,/obj/item/shard,/obj/structure/barricade,/turf/simulated/floor/plating,/area/avalon/shelter/engineering)
"L" = (/obj/structure/wall_frame/standard,/turf/simulated/floor/plating,/area/avalon/shelter/engineering)
"N" = (/turf/simulated/wall/r_wall,/area/avalon/shelter/engineering)
"O" = (/obj/item/stack/tile/floor_dark,/obj/effect/decal/cleanable/dirt,/turf/simulated/floor/asteroid,/area/avalon/shelter/engineering)
"P" = (/obj/effect/decal/cleanable/dirt,/turf/simulated/floor/asteroid,/area/avalon/shelter/engineering)
"R" = (/obj/effect/decal/cleanable/dirt,/obj/item/inflatable/door/torn,/turf/simulated/floor/plating,/area/avalon/shelter/engineering)
"V" = (/obj/effect/decal/cleanable/dirt,/obj/item/storage/toolbox/repairs,/obj/item/wrench,/turf/simulated/floor/plating,/area/avalon/shelter/engineering)
"W" = (/obj/effect/decal/cleanable/dirt,/turf/simulated/floor/plating,/area/avalon/shelter/engineering)
"Y" = (/obj/item/shard,/turf/simulated/floor/plating,/area/avalon/shelter/engineering)
"Z" = (/obj/structure/boulder,/obj/effect/decal/cleanable/dirt,/turf/simulated/floor/asteroid,/area/avalon/shelter/engineering)

(1,1,1) = {"
NffLNDHDN
NWYoheiBs
NAWtWWPss
NloAWOsss
NzWoVoqOs
aRWoWuocZ
NNNNNNNCN
"}
