"a" = (/obj/item/chems/glass/paint/random,/obj/structure/catwalk,/turf/simulated/floor/plating,/area/avalon/shelter/engineering)
"b" = (/obj/effect/decal/cleanable/blood/oil,/turf/simulated/floor/tiled/dark/monotile,/area/avalon/shelter/engineering)
"e" = (/obj/structure/catwalk,/turf/simulated/floor/plating,/area/avalon/shelter/engineering)
"i" = (/obj/structure/wall_frame/standard,/obj/structure/window/basic/full,/obj/structure/barricade,/turf/simulated/floor/plating,/area/avalon/shelter/engineering)
"j" = (/obj/structure/wall_frame/standard,/turf/simulated/floor/plating,/area/avalon/shelter/engineering)
"k" = (/obj/effect/decal/cleanable/blood/oil/streak,/obj/effect/decal/cleanable/dirt,/turf/simulated/floor/tiled/dark/monotile,/area/avalon/shelter/engineering)
"l" = (/obj/effect/decal/cleanable/dirt,/obj/random/junk,/turf/simulated/floor/plating,/area/avalon/shelter/engineering)
"o" = (/obj/effect/paint_stripe/red,/turf/simulated/wall/r_wall,/area/avalon/shelter/engineering)
"q" = (/obj/item/storage/toolbox/mechanical,/turf/simulated/floor/plating,/area/avalon/shelter/engineering)
"r" = (/obj/effect/decal/cleanable/dirt,/obj/random/junk,/turf/simulated/floor/tiled/dark/monotile,/area/avalon/shelter/engineering)
"v" = (/turf/simulated/wall/r_wall,/area/avalon/shelter/engineering)
"w" = (/obj/structure/catwalk,/obj/effect/decal/cleanable/dirt,/turf/simulated/floor/plating,/area/avalon/shelter/engineering)
"x" = (/obj/effect/decal/cleanable/dirt,/turf/simulated/floor/tiled/dark/monotile,/area/avalon/shelter/engineering)
"A" = (/obj/machinery/door/airlock/hatch,/obj/modular_map_connector,/turf/simulated/floor/plating,/area/avalon/shelter/engineering)
"C" = (/obj/item/chems/glass/paint/random,/obj/structure/catwalk,/obj/effect/decal/cleanable/dirt,/turf/simulated/floor/plating,/area/avalon/shelter/engineering)
"D" = (/obj/effect/decal/cleanable/cobweb2,/obj/random/junk,/turf/simulated/floor/tiled/dark/monotile,/area/avalon/shelter/engineering)
"E" = (/obj/structure/wall_frame/standard,/obj/item/shard,/obj/structure/barricade,/turf/simulated/floor/plating,/area/avalon/shelter/engineering)
"F" = (/obj/machinery/door/airlock/hatch{locked = 1},/turf/simulated/floor/plating,/area/avalon/shelter/engineering)
"G" = (/turf/simulated/floor/tiled/dark/monotile,/area/avalon/shelter/engineering)
"H" = (/obj/effect/decal/cleanable/cobweb{dir = 4},/obj/effect/decal/cleanable/dirt,/turf/simulated/floor/plating,/area/avalon/shelter/engineering)
"N" = (/obj/effect/decal/cleanable/blood/oil/streak,/obj/effect/decal/cleanable/dirt,/obj/item/flashlight/lamp/floodlamp,/turf/simulated/floor/tiled/dark/monotile,/area/avalon/shelter/engineering)
"R" = (/obj/item/shard,/obj/structure/catwalk,/turf/simulated/floor/plating,/area/avalon/shelter/engineering)
"S" = (/obj/effect/decal/cleanable/blood/oil/streak,/turf/simulated/floor/plating,/area/avalon/shelter/engineering)
"T" = (/obj/effect/decal/cleanable/dirt,/turf/simulated/floor/plating,/area/avalon/shelter/engineering)
"W" = (/turf/simulated/floor/plating,/area/avalon/shelter/engineering)
"X" = (/obj/effect/decal/cleanable/dirt,/obj/item/flashlight/lamp/floodlamp{dir = 4},/turf/simulated/floor/tiled/dark/monotile,/area/avalon/shelter/engineering)
"Z" = (/obj/structure/wall_frame/standard,/obj/structure/window/basic/full,/turf/simulated/floor/plating,/area/avalon/shelter/engineering)

(1,1,1) = {"
viijvZEZv
vkxRqTxDo
orbeSWwxo
oGNxxxGxo
vaweGXxCv
AHTWlwTwv
vvooovoFv
"}
