"aR" = (/obj/machinery/atmospherics/unary/vent_pump/on{dir = 8},/turf/simulated/floor/plating,/area/avalon/shelter/upperhall)
"cw" = (/obj/effect/decal/cleanable/dirt,/obj/structure/rack,/obj/random/loot,/turf/simulated/floor/plating,/area/avalon/shelter/upperhall)
"eR" = (/obj/effect/decal/cleanable/dirt,/obj/structure/rack,/obj/random/maintenance,/obj/random/loot,/turf/simulated/floor/plating,/area/avalon/shelter/upperhall)
"eV" = (/obj/effect/decal/cleanable/dirt,/obj/machinery/atmospherics/pipe/simple/visible/supply{dir = 4},/obj/machinery/atmospherics/pipe/simple/visible/scrubbers{dir = 4},/obj/structure/catwalk,/turf/simulated/floor/plating,/area/avalon/shelter/upperhall)
"fU" = (/obj/machinery/door/airlock/hatch{initial_access = list("ACCESS_MAINT")},/obj/machinery/atmospherics/pipe/simple/visible/supply,/obj/machinery/atmospherics/pipe/simple/visible/scrubbers,/obj/effect/catwalk_plated,/obj/modular_map_connector,/turf/simulated/floor/plating,/area/avalon/shelter/upperhall)
"hi" = (/obj/machinery/light/small/emergency{dir = 1},/turf/simulated/floor/plating,/area/avalon/shelter/upperhall)
"iR" = (/obj/effect/decal/cleanable/dirt,/obj/machinery/atmospherics/unary/vent_pump/on{dir = 1},/turf/simulated/floor/plating,/area/avalon/shelter/upperhall)
"iS" = (/obj/machinery/atmospherics/pipe/simple/visible/scrubbers{dir = 4},/obj/machinery/atmospherics/pipe/manifold/visible/supply{dir = 1},/obj/structure/catwalk,/turf/simulated/floor/plating,/area/avalon/shelter/upperhall)
"jf" = (/obj/machinery/atmospherics/pipe/simple/visible/supply,/obj/machinery/atmospherics/pipe/manifold/visible/scrubbers{dir = 8},/obj/structure/catwalk,/turf/simulated/floor/plating,/area/avalon/shelter/upperhall)
"jW" = (/obj/machinery/atmospherics/pipe/simple/visible/supply{dir = 4},/obj/effect/decal/cleanable/dirt,/obj/structure/catwalk,/turf/simulated/floor/plating,/area/avalon/shelter/upperhall)
"nd" = (/turf/simulated/wall,/area/avalon/shelter/upperhall)
"nV" = (/obj/machinery/atmospherics/pipe/simple/visible/scrubbers,/obj/machinery/atmospherics/pipe/manifold/visible/supply{dir = 8},/obj/structure/catwalk,/turf/simulated/floor/plating,/area/avalon/shelter/upperhall)
"pz" = (/obj/machinery/atmospherics/pipe/zpipe/up/supply{dir = 8},/obj/structure/catwalk,/turf/simulated/floor/plating,/area/avalon/shelter/upperhall)
"qN" = (/obj/machinery/light/small/emergency{dir = 1},/obj/machinery/atmospherics/pipe/simple/visible/scrubbers{dir = 4},/obj/machinery/atmospherics/pipe/simple/visible/supply{dir = 10},/obj/structure/catwalk,/turf/simulated/floor/plating,/area/avalon/shelter/upperhall)
"qU" = (/obj/structure/rack,/obj/random/maintenance,/turf/simulated/floor/plating,/area/avalon/shelter/upperhall)
"qY" = (/obj/machinery/atmospherics/unary/vent_scrubber/on{dir = 8},/turf/simulated/floor/plating,/area/avalon/shelter/upperhall)
"rU" = (/obj/machinery/atmospherics/unary/vent_pump/on{dir = 1},/turf/simulated/floor/plating,/area/avalon/shelter/upperhall)
"sZ" = (/obj/structure/barricade,/turf/simulated/floor/plating,/area/avalon/shelter/upperhall)
"us" = (/obj/machinery/atmospherics/pipe/simple/visible/supply,/obj/machinery/atmospherics/pipe/simple/visible/scrubbers,/obj/machinery/light/small/emergency{dir = 4},/obj/effect/decal/cleanable/dirt,/obj/structure/catwalk,/turf/simulated/floor/plating,/area/avalon/shelter/upperhall)
"uB" = (/turf/simulated/floor/plating,/area/avalon/shelter/upperhall)
"uL" = (/obj/machinery/atmospherics/pipe/simple/visible/supply{dir = 4},/obj/machinery/atmospherics/pipe/simple/visible/scrubbers{dir = 4},/obj/structure/catwalk,/turf/simulated/floor/plating,/area/avalon/shelter/upperhall)
"xK" = (/turf/exterior/wall,/area/template_noop)
"yR" = (/obj/machinery/atmospherics/pipe/simple/visible/supply{dir = 4},/obj/effect/decal/cleanable/dirt,/obj/machinery/light/small/emergency{dir = 1},/obj/structure/catwalk,/turf/simulated/floor/plating,/area/avalon/shelter/upperhall)
"zs" = (/obj/machinery/atmospherics/pipe/simple/visible/supply,/obj/machinery/atmospherics/pipe/simple/visible/scrubbers,/obj/effect/decal/cleanable/dirt,/obj/structure/catwalk,/turf/simulated/floor/plating,/area/avalon/shelter/upperhall)
"Bq" = (/obj/structure/rack,/obj/machinery/light/small/emergency{dir = 1},/obj/effect/decal/cleanable/dirt,/obj/random/maintenance,/obj/random/loot,/turf/simulated/floor/plating,/area/avalon/shelter/upperhall)
"EU" = (/obj/machinery/light/small/emergency,/turf/simulated/floor/plating,/area/avalon/shelter/upperhall)
"Fd" = (/obj/machinery/door/airlock/hatch{locked = 1},/turf/simulated/floor/plating,/area/avalon/shelter/upperhall)
"Ic" = (/obj/machinery/atmospherics/pipe/simple/visible/scrubbers,/obj/machinery/atmospherics/pipe/simple/visible/supply,/obj/structure/catwalk,/turf/simulated/floor/plating,/area/avalon/shelter/upperhall)
"Ih" = (/obj/machinery/atmospherics/pipe/simple/visible/scrubbers,/obj/machinery/atmospherics/pipe/simple/visible/supply,/obj/machinery/door/airlock/hatch{initial_access = list("ACCESS_MAINT")},/obj/effect/catwalk_plated,/turf/simulated/floor/plating,/area/avalon/shelter/upperhall)
"Kd" = (/obj/machinery/atmospherics/pipe/simple/visible/scrubbers{dir = 10},/obj/machinery/atmospherics/pipe/simple/visible/supply{dir = 4},/obj/effect/decal/cleanable/dirt,/obj/structure/catwalk,/turf/simulated/floor/plating,/area/avalon/shelter/upperhall)
"KQ" = (/obj/effect/decal/cleanable/dirt,/turf/simulated/floor/plating,/area/avalon/shelter/upperhall)
"Mc" = (/obj/machinery/atmospherics/unary/vent_scrubber/on{dir = 1},/turf/simulated/floor/plating,/area/avalon/shelter/upperhall)
"MN" = (/obj/machinery/door/airlock/hatch{locked = 1; initial_access = list("ACCESS_MAINT")},/turf/simulated/floor/plating,/area/avalon/shelter/upperhall)
"Ot" = (/obj/machinery/atmospherics/pipe/simple/visible/supply,/obj/machinery/atmospherics/pipe/simple/visible/scrubbers,/obj/structure/catwalk,/turf/simulated/floor/plating,/area/avalon/shelter/upperhall)
"Qc" = (/turf/exterior/wall,/area/avalon/shelter/upperhall)
"Qk" = (/obj/machinery/atmospherics/pipe/manifold/visible/scrubbers{dir = 8},/obj/machinery/atmospherics/pipe/manifold/visible/supply{dir = 8},/obj/structure/catwalk,/turf/simulated/floor/plating,/area/avalon/shelter/upperhall)
"Rn" = (/obj/random/obstruction,/turf/simulated/floor/plating,/area/avalon/shelter/upperhall)
"RA" = (/turf/template_noop,/area/template_noop)
"Sc" = (/obj/effect/decal/cleanable/dirt,/obj/machinery/floodlight,/turf/simulated/floor/plating,/area/avalon/shelter/upperhall)
"TA" = (/obj/machinery/atmospherics/pipe/simple/visible/supply{dir = 6},/obj/machinery/atmospherics/pipe/simple/visible/scrubbers{dir = 6},/obj/structure/catwalk,/turf/simulated/floor/plating,/area/avalon/shelter/upperhall)
"TX" = (/obj/machinery/atmospherics/pipe/simple/visible/scrubbers{dir = 10},/obj/structure/catwalk,/turf/simulated/floor/plating,/area/avalon/shelter/upperhall)
"Ue" = (/obj/machinery/atmospherics/pipe/simple/visible/supply{dir = 4},/obj/structure/catwalk,/turf/simulated/floor/plating,/area/avalon/shelter/upperhall)
"Uw" = (/obj/machinery/atmospherics/pipe/simple/visible/supply{dir = 4},/obj/machinery/light/small/emergency{dir = 1},/obj/structure/catwalk,/turf/simulated/floor/plating,/area/avalon/shelter/upperhall)
"UX" = (/obj/machinery/door/airlock/hatch{initial_access = list("ACCESS_MAINT")},/obj/machinery/atmospherics/pipe/simple/visible/supply{dir = 4},/obj/machinery/atmospherics/pipe/simple/visible/scrubbers{dir = 4},/turf/simulated/floor/plating,/area/avalon/shelter/upperhall)
"Vh" = (/obj/machinery/door/airlock/hatch{initial_access = list("ACCESS_MAINT")},/obj/machinery/atmospherics/pipe/simple/visible/supply{dir = 4},/obj/machinery/atmospherics/pipe/simple/visible/scrubbers{dir = 4},/obj/effect/catwalk_plated,/turf/simulated/floor/plating,/area/avalon/shelter/upperhall)
"Wa" = (/obj/machinery/light/small/emergency{dir = 4},/obj/effect/decal/cleanable/dirt,/turf/simulated/floor/plating,/area/avalon/shelter/upperhall)
"WL" = (/obj/machinery/atmospherics/unary/vent_pump/on{dir = 8},/obj/machinery/light/small/emergency{dir = 4},/turf/simulated/floor/plating,/area/avalon/shelter/upperhall)
"XY" = (/turf/simulated/wall/r_wall,/area/avalon/shelter/upperhall)
"Yt" = (/obj/machinery/atmospherics/pipe/simple/visible/scrubbers,/obj/machinery/atmospherics/pipe/simple/visible/supply,/obj/machinery/light/small/emergency{dir = 8},/obj/structure/catwalk,/turf/simulated/floor/plating,/area/avalon/shelter/upperhall)
"ZF" = (/obj/machinery/door/airlock/hatch{initial_access = list("ACCESS_MAINT")},/obj/machinery/atmospherics/pipe/simple/visible/scrubbers,/obj/machinery/atmospherics/pipe/simple/visible/supply,/obj/effect/catwalk_plated,/turf/simulated/floor/plating,/area/avalon/shelter/upperhall)

(1,1,1) = {"
ndndndndndndndndndndndndndndndndndndndndndndndndndndndndnd
ndTAUXiSKdUeyRUejWjWUeUeUwpzuBMNKQuBhiKQuBuBuBuBuBuBKQuBXY
ndIcndrUMcndndndndndndndndndndndndndKQndndndndndndndnduBXY
ndIcndndndndRARARARARARARARARARARAndndndRARARARARARAndWaXY
ndYtndRARARARARARARARARARARARARARARARARARARARARARARAndKQXY
ndIcndndRARARARARARARARARARARARARARARARARARARARARARAnduBFd
ndnVaRndRARARARARARARARARAndndndndndndndndndndndndndnduBXY
ndjfqYndRARARARARARARARARAndKQKQKQuBuBuBKQuBRnuBKQKQuBKQnd
ndIhndndRARARARARARARARARAnduBndndndndSceRQcKQuBEUcwRnndnd
ndnVWLndRARARARARARARARARAndKQndRARAQcQcQcQcQcQcndQcQcxKRA
ndjfqYndRARARAndRARARARARAnduBndRARARARARARARARARARARARARA
ndZFndndndndqUBquBndndndndndKQndRARARARARARARARARARARARARA
ndQkuLVhuLeVuLeVuLeVeVVheVqNTXndRARARARARARARARARARARARARA
ndOtuBndndndndndndndndndKQiRMcndRARARARARARARARARARARARARA
sZzsuBndRARARARARARARAndndRARARARARARARARARARARARARARARARA
sZzsKQndRARARARARARARARARARARARARARARARARARARARARARARARARA
sZOtKQndRARARARARARARARARARARARARARARARARARARARARARARARARA
ndOtndndRARARARARARARARARARARARARARARARARARARARARARARARARA
ndusndRARARARARARARARARARARARARARARARARARARARARARARARARARA
ndOtndRARARARARARARARARARARARARARARARARARARARARARARARARARA
ndfUndRARARARARARARARARARARARARARARARARARARARARARARARARARA
"}
