"gd" = (/obj/effect/decal/cleanable/dirt,/obj/modular_map_anchor/avalon{name = "upperhall_attachment_a"; key = "upperhall_attachment_a"},/turf/simulated/floor/plating,/area/avalon/shelter/upperhall)
"gA" = (/obj/machinery/door/airlock/hatch{initial_access = list("ACCESS_MAINT")},/obj/machinery/atmospherics/pipe/simple/visible/supply{dir = 4},/obj/machinery/atmospherics/pipe/simple/visible/scrubbers{dir = 4},/turf/simulated/floor/plating,/area/avalon/shelter/upperhall)
"gY" = (/obj/machinery/atmospherics/unary/vent_scrubber/on{dir = 8},/turf/simulated/floor/plating,/area/avalon/shelter/upperhall)
"ij" = (/obj/structure/mattress,/obj/random/junk,/turf/simulated/floor/plating,/area/avalon/shelter/upperhall)
"kh" = (/obj/machinery/atmospherics/unary/vent_pump/on{dir = 1},/turf/simulated/floor/plating,/area/avalon/shelter/upperhall)
"ku" = (/obj/structure/ladder,/obj/effect/decal/cleanable/dirt,/turf/simulated/floor/plating,/area/avalon/shelter/upperhall)
"kv" = (/obj/machinery/atmospherics/pipe/simple/visible/scrubbers{dir = 10},/obj/machinery/atmospherics/pipe/simple/visible/supply{dir = 4},/obj/effect/decal/cleanable/dirt,/turf/simulated/floor/plating,/area/avalon/shelter/upperhall)
"ky" = (/obj/machinery/atmospherics/pipe/simple/visible/supply{dir = 4},/obj/machinery/atmospherics/pipe/simple/visible/scrubbers{dir = 4},/turf/simulated/floor/plating,/area/avalon/shelter/upperhall)
"lR" = (/turf/template_noop,/area/template_noop)
"mR" = (/turf/simulated/wall,/area/avalon/shelter/upperhall)
"nN" = (/obj/machinery/atmospherics/pipe/simple/visible/supply{dir = 6},/obj/machinery/atmospherics/pipe/simple/visible/scrubbers{dir = 6},/turf/simulated/floor/plating,/area/avalon/shelter/upperhall)
"nP" = (/obj/effect/decal/cleanable/dirt,/obj/machinery/floodlight,/turf/simulated/floor/plating,/area/avalon/shelter/upperhall)
"pJ" = (/obj/machinery/light/small/emergency{dir = 4},/obj/effect/decal/cleanable/dirt,/turf/simulated/floor/plating,/area/avalon/shelter/upperhall)
"sf" = (/obj/machinery/atmospherics/pipe/zpipe/up/supply{dir = 8},/turf/simulated/floor/plating,/area/avalon/shelter/upperhall)
"sX" = (/obj/machinery/atmospherics/pipe/simple/visible/supply{dir = 4},/obj/machinery/light/small/emergency{dir = 1},/turf/simulated/floor/plating,/area/avalon/shelter/upperhall)
"tC" = (/obj/machinery/atmospherics/pipe/simple/visible/scrubbers,/obj/machinery/atmospherics/pipe/manifold/visible/supply{dir = 8},/obj/effect/catwalk_plated,/turf/simulated/floor/plating,/area/avalon/shelter/upperhall)
"uq" = (/obj/machinery/atmospherics/pipe/simple/visible/supply,/obj/machinery/atmospherics/pipe/manifold/visible/scrubbers{dir = 8},/turf/simulated/floor/plating,/area/avalon/shelter/upperhall)
"uH" = (/obj/machinery/atmospherics/pipe/simple/visible/supply,/obj/machinery/atmospherics/pipe/manifold/visible/scrubbers{dir = 8},/obj/effect/catwalk_plated,/turf/simulated/floor/plating,/area/avalon/shelter/upperhall)
"vR" = (/obj/machinery/atmospherics/pipe/simple/visible/supply,/obj/machinery/atmospherics/pipe/simple/visible/scrubbers,/obj/machinery/light/small/emergency{dir = 4},/obj/effect/decal/cleanable/dirt,/turf/simulated/floor/plating,/area/avalon/shelter/upperhall)
"xu" = (/obj/machinery/atmospherics/pipe/simple/visible/scrubbers,/obj/machinery/atmospherics/pipe/simple/visible/supply,/obj/machinery/light/small/emergency{dir = 8},/turf/simulated/floor/plating,/area/avalon/shelter/upperhall)
"Be" = (/obj/abstract/landmark/corpse/engineer,/obj/effect/decal/cleanable/vomit,/obj/effect/decal/cleanable/dirt,/turf/simulated/floor/asteroid,/area/avalon/shelter/upperhall)
"Ca" = (/turf/exterior/wall,/area/avalon/shelter/upperhall)
"Cl" = (/obj/machinery/door/airlock/hatch{initial_access = list("ACCESS_MAINT")},/obj/machinery/atmospherics/pipe/simple/visible/scrubbers,/obj/machinery/atmospherics/pipe/simple/visible/supply,/turf/simulated/floor/plating,/area/avalon/shelter/upperhall)
"Cs" = (/obj/machinery/atmospherics/unary/vent_pump/on{dir = 8},/obj/machinery/light/small/emergency{dir = 4},/turf/simulated/floor/plating,/area/avalon/shelter/upperhall)
"Dk" = (/obj/structure/boulder,/obj/effect/decal/cleanable/dirt,/turf/simulated/floor/asteroid,/area/avalon/shelter/upperhall)
"Ff" = (/obj/machinery/atmospherics/unary/vent_pump/on{dir = 8},/turf/simulated/floor/plating,/area/avalon/shelter/upperhall)
"Gx" = (/obj/structure/rack,/obj/random/maintenance,/turf/simulated/floor/plating,/area/avalon/shelter/upperhall)
"GN" = (/obj/machinery/door/airlock/hatch{initial_access = list("ACCESS_MAINT")},/obj/machinery/atmospherics/pipe/simple/visible/supply,/obj/machinery/atmospherics/pipe/simple/visible/scrubbers,/obj/modular_map_connector,/turf/simulated/floor/plating,/area/avalon/shelter/upperhall)
"GY" = (/obj/machinery/door/airlock/hatch{locked = 1; initial_access = list("ACCESS_MAINT")},/turf/simulated/floor/plating,/area/avalon/shelter/upperhall)
"He" = (/obj/effect/decal/cleanable/dirt,/turf/simulated/floor/plating,/area/avalon/shelter/upperhall)
"Iq" = (/obj/structure/rack,/obj/machinery/light/small/emergency{dir = 1},/obj/effect/decal/cleanable/dirt,/obj/random/maintenance,/obj/random/loot,/turf/simulated/floor/plating,/area/avalon/shelter/upperhall)
"IU" = (/obj/modular_map_anchor/avalon{name = "upperhall_attachment_b"; key = "upperhall_attachment_b"},/turf/simulated/floor/plating,/area/avalon/shelter/upperhall)
"Ji" = (/obj/machinery/atmospherics/pipe/simple/visible/supply{dir = 4},/obj/effect/decal/cleanable/dirt,/obj/machinery/light/small/emergency{dir = 1},/turf/simulated/floor/plating,/area/avalon/shelter/upperhall)
"JO" = (/obj/machinery/atmospherics/pipe/simple/visible/supply{dir = 4},/obj/effect/decal/cleanable/dirt,/turf/simulated/floor/plating,/area/avalon/shelter/upperhall)
"NF" = (/obj/machinery/atmospherics/pipe/simple/visible/scrubbers{dir = 4},/obj/machinery/atmospherics/pipe/manifold/visible/supply{dir = 1},/turf/simulated/floor/plating,/area/avalon/shelter/upperhall)
"NY" = (/obj/machinery/atmospherics/unary/vent_scrubber/on{dir = 1},/turf/simulated/floor/plating,/area/avalon/shelter/upperhall)
"Po" = (/obj/machinery/light/small/emergency,/turf/simulated/floor/plating,/area/avalon/shelter/upperhall)
"Pz" = (/obj/machinery/atmospherics/pipe/simple/visible/supply,/obj/machinery/atmospherics/pipe/simple/visible/scrubbers,/turf/simulated/floor/plating,/area/avalon/shelter/upperhall)
"PB" = (/obj/effect/decal/cleanable/dirt,/obj/item/flashlight/flare/glowstick,/obj/random/maintenance,/turf/simulated/floor/plating,/area/avalon/shelter/upperhall)
"PP" = (/turf/simulated/wall/r_wall,/area/avalon/shelter/upperhall)
"QN" = (/obj/effect/decal/cleanable/dirt,/obj/structure/rack,/obj/random/loot,/turf/simulated/floor/plating,/area/avalon/shelter/upperhall)
"RW" = (/obj/effect/decal/cleanable/dirt,/obj/machinery/atmospherics/pipe/simple/visible/supply{dir = 4},/obj/machinery/atmospherics/pipe/simple/visible/scrubbers{dir = 4},/turf/simulated/floor/plating,/area/avalon/shelter/upperhall)
"Tr" = (/obj/effect/decal/cleanable/dirt,/obj/machinery/atmospherics/unary/vent_pump/on{dir = 1},/turf/simulated/floor/plating,/area/avalon/shelter/upperhall)
"Ug" = (/obj/effect/decal/cleanable/dirt,/obj/structure/rack,/obj/random/maintenance,/obj/random/loot,/turf/simulated/floor/plating,/area/avalon/shelter/upperhall)
"Ur" = (/obj/machinery/atmospherics/pipe/simple/visible/scrubbers,/obj/machinery/atmospherics/pipe/simple/visible/supply,/obj/machinery/door/airlock/hatch{initial_access = list("ACCESS_MAINT")},/turf/simulated/floor/plating,/area/avalon/shelter/upperhall)
"UO" = (/obj/machinery/light/small/emergency{dir = 1},/turf/simulated/floor/plating,/area/avalon/shelter/upperhall)
"UU" = (/obj/machinery/atmospherics/pipe/simple/visible/scrubbers{dir = 10},/obj/structure/catwalk,/turf/simulated/floor/plating,/area/avalon/shelter/upperhall)
"VD" = (/obj/machinery/atmospherics/pipe/simple/visible/scrubbers,/obj/machinery/atmospherics/pipe/simple/visible/supply,/turf/simulated/floor/plating,/area/avalon/shelter/upperhall)
"VM" = (/turf/simulated/floor/plating,/area/avalon/shelter/upperhall)
"VU" = (/obj/machinery/atmospherics/pipe/simple/visible/supply{dir = 4},/turf/simulated/floor/plating,/area/avalon/shelter/upperhall)
"Wf" = (/obj/machinery/atmospherics/pipe/simple/visible/scrubbers,/obj/machinery/atmospherics/pipe/manifold/visible/supply{dir = 8},/turf/simulated/floor/plating,/area/avalon/shelter/upperhall)
"Wr" = (/obj/machinery/light/small/emergency{dir = 1},/obj/machinery/atmospherics/pipe/simple/visible/scrubbers{dir = 4},/obj/machinery/atmospherics/pipe/simple/visible/supply{dir = 10},/obj/structure/catwalk,/turf/simulated/floor/plating,/area/avalon/shelter/upperhall)
"Wu" = (/obj/machinery/atmospherics/pipe/manifold/visible/scrubbers{dir = 8},/obj/machinery/atmospherics/pipe/manifold/visible/supply{dir = 8},/turf/simulated/floor/plating,/area/avalon/shelter/upperhall)
"Yk" = (/obj/machinery/atmospherics/pipe/simple/visible/supply,/obj/machinery/atmospherics/pipe/simple/visible/scrubbers,/obj/effect/decal/cleanable/dirt,/turf/simulated/floor/plating,/area/avalon/shelter/upperhall)
"Yt" = (/obj/machinery/door/airlock/hatch{locked = 1},/turf/simulated/floor/plating,/area/avalon/shelter/upperhall)
"Zv" = (/obj/random/obstruction,/turf/simulated/floor/plating,/area/avalon/shelter/upperhall)

(1,1,1) = {"
mRmRmRmRmRmRmRmRmRmRmRmRmRmRmRmRmRmRmRmRmRmRmRCamRmRmRmRmR
mRnNgANFkvVUJiVUJOJOVUVUsXsfVMGYHeVMUOHeCaCaijPBCaDkHeVMPP
mRVDmRkhNYmRmRmRIUmRmRmRmRmRmRmRmRmRkumRmRCaBemRCamRmRVMPP
mRVDmRmRmRmRlRlRlRlRlRlRlRlRlRlRlRmRmRmRlRCaCaCalRlRmRpJPP
mRxumRlRlRlRlRlRlRlRlRlRlRlRlRlRlRlRlRlRlRlRlRlRlRlRmRHePP
mRVDmRmRlRlRlRlRlRlRlRlRlRlRlRlRlRlRlRlRlRlRlRlRlRlRmRVMYt
mRWfFfmRlRlRlRlRlRlRlRlRlRmRmRmRmRmRmRmRmRmRmRmRmRmRmRVMPP
mRuHgYmRlRlRlRlRlRlRlRlRlRmRHeHeHeVMVMVMHeVMZvVMHeHeVMHemR
mRUrmRmRlRlRlRlRlRlRlRlRlRmRVMmRmRmRmRnPUgCaHeVMPoQNZvmRmR
mRtCCsmRlRlRlRlRlRlRlRlRlRmRHemRlRlRCaCaCaCaCaCamRCaCaCalR
mRuqgYmRlRlRlRmRlRlRlRlRlRmRVMmRlRlRlRlRlRlRlRlRlRlRlRlRlR
mRClmRmRmRmRGxIqVMmRmRmRmRmRHemRlRlRlRlRlRlRlRlRlRlRlRlRlR
mRWukygAkyRWkyRWkyRWRWgARWWrUUmRlRlRlRlRlRlRlRlRlRlRlRlRlR
mRPzVMmRmRmRmRmRmRmRmRmRHeTrNYmRlRlRlRlRlRlRlRlRlRlRlRlRlR
VMYkVMlRlRlRlRlRlRlRlRmRmRlRlRlRlRlRlRlRlRlRlRlRlRlRlRlRlR
VMYkgdlRlRlRlRlRlRlRlRlRlRlRlRlRlRlRlRlRlRlRlRlRlRlRlRlRlR
VMPzHelRlRlRlRlRlRlRlRlRlRlRlRlRlRlRlRlRlRlRlRlRlRlRlRlRlR
mRPzmRlRlRlRlRlRlRlRlRlRlRlRlRlRlRlRlRlRlRlRlRlRlRlRlRlRlR
mRvRmRlRlRlRlRlRlRlRlRlRlRlRlRlRlRlRlRlRlRlRlRlRlRlRlRlRlR
mRPzmRlRlRlRlRlRlRlRlRlRlRlRlRlRlRlRlRlRlRlRlRlRlRlRlRlRlR
mRGNmRlRlRlRlRlRlRlRlRlRlRlRlRlRlRlRlRlRlRlRlRlRlRlRlRlRlR
"}
