//MAP CONVERTED BY dmm2tgm.py THIS HEADER COMMENT PREVENTS RECONVERSION, DO NOT REMOVE
"a" = (
/turf/template_noop,
/area/template_noop)
"b" = (
/obj/structure/catwalk,
/obj/structure/bed/padded,
/obj/structure/curtain/open/bed,
/obj/effect/decal/cleanable/dirt,
/obj/item/remains/human,
/turf/simulated/floor/plating,
/area/avalon/shelter/upperhall)
"f" = (
/obj/modular_map_connector,
/turf/simulated/floor/plating,
/area/avalon/shelter/upperhall)
"j" = (
/turf/exterior/wall,
/area/avalon/shelter/upperhall)
"o" = (
/obj/structure/catwalk,
/obj/effect/decal/cleanable/dirt,
/turf/simulated/floor/plating,
/area/avalon/shelter/upperhall)
"w" = (
/obj/structure/catwalk,
/obj/structure/closet/secure_closet/freezer/fridge,
/obj/effect/decal/cleanable/dirt,
/turf/simulated/floor/plating,
/area/avalon/shelter/upperhall)
"z" = (
/obj/structure/catwalk,
/obj/item/flashlight/lantern,
/obj/structure/table/reinforced,
/turf/simulated/floor/plating,
/area/avalon/shelter/upperhall)
"A" = (
/obj/effect/decal/cleanable/dirt,
/turf/exterior/barren,
/area/avalon/shelter/upperhall)
"B" = (
/obj/item/stack/material/rods,
/obj/structure/boulder,
/obj/effect/decal/cleanable/dirt,
/turf/exterior/barren,
/area/avalon/shelter/upperhall)
"C" = (
/obj/structure/boulder,
/obj/effect/decal/cleanable/dirt,
/turf/exterior/barren,
/area/avalon/shelter/upperhall)
"G" = (
/obj/structure/catwalk,
/obj/structure/table/reinforced,
/obj/machinery/microwave,
/turf/simulated/floor/plating,
/area/avalon/shelter/upperhall)
"M" = (
/turf/exterior/barren,
/area/avalon/shelter/upperhall)
"T" = (
/obj/structure/catwalk,
/obj/item/frame/light/small,
/obj/effect/decal/cleanable/dirt,
/turf/simulated/floor/plating,
/area/avalon/shelter/upperhall)
"V" = (
/turf/simulated/wall,
/area/avalon/shelter/upperhall)
"Z" = (
/obj/structure/catwalk,
/obj/item/broken_bottle,
/turf/simulated/floor/plating,
/area/avalon/shelter/upperhall)

(1,1,1) = {"
V
V
j
V
V
V
V
"}
(2,1,1) = {"
V
j
j
C
T
b
V
"}
(3,1,1) = {"
V
j
A
M
A
z
V
"}
(4,1,1) = {"
f
M
A
V
Z
V
V
"}
(5,1,1) = {"
V
j
V
V
o
G
V
"}
(6,1,1) = {"
V
a
V
B
o
w
V
"}
(7,1,1) = {"
V
a
V
V
V
V
V
"}
