//MAP CONVERTED BY dmm2tgm.py THIS HEADER COMMENT PREVENTS RECONVERSION, DO NOT REMOVE
"a" = (
/turf/template_noop,
/area/template_noop)
"b" = (
/obj/machinery/portable_atmospherics/hydroponics/soil,
/turf/exterior/barren,
/area/avalon/shelter/upperhall)
"f" = (
/obj/effect/decal/cleanable/dirt,
/obj/modular_map_connector,
/turf/simulated/floor/plating,
/area/avalon/shelter/upperhall)
"j" = (
/turf/exterior/wall,
/area/avalon/shelter/upperhall)
"o" = (
/obj/machinery/portable_atmospherics/hydroponics/soil,
/obj/effect/dead_plant,
/obj/effect/decal/cleanable/dirt,
/turf/exterior/barren,
/area/avalon/shelter/upperhall)
"w" = (
/turf/simulated/wall/wood,
/area/avalon/shelter/upperhall)
"z" = (
/obj/effect/decal/cleanable/dirt,
/obj/machinery/light/ultraviolet,
/turf/exterior/barren,
/area/avalon/shelter/upperhall)
"A" = (
/obj/effect/decal/cleanable/dirt,
/turf/exterior/barren,
/area/avalon/shelter/upperhall)
"B" = (
/obj/machinery/portable_atmospherics/hydroponics/soil,
/obj/effect/dead_plant,
/turf/exterior/barren,
/area/avalon/shelter/upperhall)
"C" = (
/obj/structure/boulder,
/obj/effect/decal/cleanable/dirt,
/turf/exterior/barren,
/area/avalon/shelter/upperhall)
"G" = (
/obj/structure/boulder,
/turf/exterior/barren,
/area/avalon/shelter/upperhall)
"M" = (
/turf/exterior/barren,
/area/avalon/shelter/upperhall)
"T" = (
/obj/item/pickaxe,
/obj/effect/decal/cleanable/dirt,
/turf/exterior/barren,
/area/avalon/shelter/upperhall)
"V" = (
/obj/machinery/light/ultraviolet{
	dir = 4
	},
/turf/exterior/barren,
/area/avalon/shelter/upperhall)

(1,1,1) = {"
a
a
a
j
j
j
a
"}
(2,1,1) = {"
a
a
j
j
T
j
j
"}
(3,1,1) = {"
a
j
j
B
M
z
w
"}
(4,1,1) = {"
a
j
j
b
A
o
j
"}
(5,1,1) = {"
f
A
M
M
M
G
j
"}
(6,1,1) = {"
a
j
C
B
M
j
j
"}
(7,1,1) = {"
a
j
j
A
V
b
j
"}
(8,1,1) = {"
a
a
j
j
w
j
j
"}
