//MAP CONVERTED BY dmm2tgm.py THIS HEADER COMMENT PREVENTS RECONVERSION, DO NOT REMOVE
"a" = (
/turf/template_noop,
/area/template_noop)
"b" = (
/obj/structure/girder,
/turf/exterior/barren,
/area/avalon/shelter/upperhall)
"f" = (
/obj/item/flashlight/lamp/floodlamp{
	dir = 4
	},
/turf/simulated/floor/plating,
/area/avalon/shelter/upperhall)
"j" = (
/turf/exterior/wall,
/area/avalon/shelter/upperhall)
"o" = (
/obj/structure/inflatable/door,
/obj/effect/decal/cleanable/dirt,
/turf/simulated/floor/plating,
/area/avalon/shelter/upperhall)
"t" = (
/obj/structure/girder,
/obj/effect/decal/cleanable/dirt,
/turf/simulated/floor/asteroid,
/area/avalon/shelter/upperhall)
"w" = (
/turf/simulated/floor/plating,
/area/avalon/shelter/upperhall)
"z" = (
/turf/simulated/wall,
/area/avalon/shelter/upperhall)
"A" = (
/obj/effect/decal/cleanable/dirt,
/turf/exterior/barren,
/area/avalon/shelter/upperhall)
"B" = (
/obj/structure/inflatable,
/turf/simulated/floor/plating,
/area/avalon/shelter/upperhall)
"C" = (
/obj/structure/boulder,
/obj/effect/decal/cleanable/dirt,
/turf/exterior/barren,
/area/avalon/shelter/upperhall)
"G" = (
/obj/modular_map_connector,
/turf/simulated/floor/plating,
/area/avalon/shelter/upperhall)
"M" = (
/turf/exterior/barren,
/area/avalon/shelter/upperhall)
"T" = (
/obj/effect/decal/cleanable/dirt,
/turf/simulated/floor/plating,
/area/avalon/shelter/upperhall)
"V" = (
/obj/item/storage/briefcase/inflatable,
/obj/effect/decal/cleanable/dirt,
/turf/simulated/floor/plating,
/area/avalon/shelter/upperhall)

(1,1,1) = {"
a
G
a
a
a
"}
(2,1,1) = {"
V
w
T
z
a
"}
(3,1,1) = {"
T
B
o
z
a
"}
(4,1,1) = {"
B
B
T
j
j
"}
(5,1,1) = {"
T
f
T
C
j
"}
(6,1,1) = {"
t
T
M
A
j
"}
(7,1,1) = {"
A
M
A
b
j
"}
(8,1,1) = {"
j
C
j
j
j
"}
(9,1,1) = {"
j
j
j
a
a
"}
